ITEM_ID,OFFER_KIND_NM,DC_AMT_PER_ONE,DC_RATE_PER_ONE,ORD_AMT_PER_ONE,DC_AMT,TOTAL_ORD_CNT_SUM,RLOAD_AMT_SUM,ORD_AMT_SUM
2.10E+12,200,5925,15,39500,65175,11,369325,434500
1.00E+12,310,2432,7,34750,2432,1,32318,34750
1.00E+12,200,5577,18.7,29800,5577,1,24223,29800
1.00E+12,310,152,7,2180,1064,7,14196,15260
1.00E+12,310,474,7,6780,474,1,6306,6780
1.00E+12,100,5782,11.8,49000,5782,1,43218,49000
1.00E+12,310,1050,10,10500,1050,1,9450,10500
1.00E+12,310,1977,9.9,19980,1977,1,18003,19980
8082208,310,84,5,1680,168,2,3192,3360
1.00E+12,310,349,5,6980,1396,4,26524,27920
7081031,310,55,5,1100,1100,20,20900,22000
2.10E+12,200,1590,12.4,12800,3180,2,22420,25600
1.00E+12,310,698,10,6980,698,1,6282,6980
1.00E+12,200,3735,15,24900,22410,6,126990,149400
2.10E+12,310,3484,35.2,9900,24388,7,44912,69300
2.10E+12,200,3484,35.2,9900,24388,7,44912,69300
1.00E+12,240,8736,20.8,42000,8736,1,33264,42000
1.00E+12,310,164,5,3280,164,1,3116,3280
7050044,310,149,5,2980,2086,14,39634,41720
7922209,310,298,10,2980,2980,10,26820,29800
1.00E+12,310,448,10,4480,3584,8,32256,35840
1.00E+12,200,14507,16.3,89000,116056,8,595944,712000
1.00E+12,205,4656,33.5,13900,4656,1,9244,13900
7252797,100,540,5,10800,1080,2,20520,21600
8333613,310,558,14.5,3850,1116,2,6584,7700
9588871,310,319,9.7,3280,319,1,2961,3280
8333613,100,558,14.5,3850,1116,2,6584,7700
8480229,310,343,7,4900,343,1,4557,4900
1.00E+12,310,134,5,2680,938,7,17822,18760
1.00E+12,200,6540,20.4,32000,6540,1,25460,32000
1.00E+12,300,6540,20.4,32000,6540,1,25460,32000
1.00E+12,200,6350,16.3,39000,6350,1,32650,39000
1.00E+12,300,7980,20.5,39000,7980,1,31020,39000
2.10E+12,200,1370,20,6850,4110,3,16440,20550
1.00E+12,300,8960,24.9,36000,8960,1,27040,36000
1.00E+12,200,10782,18,59900,21564,2,98236,119800
2.10E+12,310,255,5,5100,255,1,4845,5100
1.00E+12,205,1250,10,12500,3750,3,33750,37500
1.00E+12,500,126915,13.6,933200,126915,1,806285,933200
1.00E+12,200,13104,9.8,134400,13104,1,121296,134400
1.00E+12,310,849,5,16980,1698,2,32262,33960
1.00E+12,300,2500,7,35480,7500,3,98940,106440
1.00E+12,500,0,0,55000,0,1,55000,55000
1.00E+12,200,890,5,17910,890,1,17020,17910
6977207,310,178,10,1780,1424,8,12816,14240
1.00E+12,310,598,10,5980,2392,4,21528,23920
3289594,200,2000,10,20000,2000,1,18000,20000
1.00E+12,200,8395,23.3,36000,8395,1,27605,36000
1.00E+12,310,748,10,7480,2992,4,26928,29920
1.00E+12,310,599,5,11980,3594,6,68286,71880
1.00E+12,310,400,10,4000,3600,9,32400,36000
2.10E+12,310,4480,25.2,17800,35840,8,106560,142400
1.00E+12,310,116,11.7,990,232,2,1748,1980
1.00E+12,501,268,11.8,2280,3216,12,24144,27360
8083024,501,433,11.8,3680,2598,6,19482,22080
1.00E+12,501,1438,20.6,6980,1438,1,5542,6980
1.00E+12,340,271,7,3880,271,1,3609,3880
7922209,340,208,7,2980,416,2,5544,5960
1.00E+12,200,632,8,7900,632,1,7268,7900
9701616,310,558,7,7980,5580,10,74220,79800
1.00E+12,200,9947,14.5,68600,9947,1,58653,68600
9654372,310,178,6.6,2680,178,1,2502,2680
1.00E+12,310,198,6.6,2980,198,1,2782,2980
1.00E+12,310,564,6.7,8480,564,1,7916,8480
6610778,310,351,6.6,5280,351,1,4929,5280
1.00E+12,310,198,6.6,2980,198,1,2782,2980
1.00E+12,310,595,6.6,8950,595,1,8355,8950
1.00E+12,310,698,10,6980,10470,15,94230,104700
1.00E+12,310,348,10,3480,348,1,3132,3480
1.00E+12,310,175,7,2500,4550,26,60450,65000
2.10E+12,310,320,7,4580,2240,7,29820,32060
2.10E+12,310,299,5,5980,598,2,11362,11960
10698740,310,768,9.1,8480,768,1,7712,8480
8123182,310,592,13.8,4280,592,1,3688,4280
2.10E+12,100,1218,13.8,8800,1218,1,7582,8800
8333662,240,308,10,3080,6468,21,58212,64680
1.00E+12,310,98,10,980,784,8,7056,7840
1.00E+12,200,9625,31.1,30900,86625,9,191475,278100
1.00E+12,300,9625,31.1,30900,86625,9,191475,278100
2.10E+12,205,676,20,3380,2704,4,10816,13520
1.00E+12,310,189,6.8,2780,189,1,2591,2780
1.00E+12,310,843,8.8,9580,1686,2,17474,19160
1.00E+12,240,1450,50,2900,131950,91,131950,263900
1.00E+12,240,1708,35,4880,5124,3,9516,14640
1.00E+12,310,278,10,2780,4170,15,37530,41700
6615168,310,338,10,3380,2704,8,24336,27040
1.00E+12,310,450,10,4500,450,1,4050,4500
1.00E+12,100,495,5,9900,990,2,18810,19800
9662033,310,284,9.8,2900,284,1,2616,2900
7657393,310,258,10,2580,258,1,2322,2580
1.00E+12,310,102,10,1020,612,6,5508,6120
1.00E+12,310,68,6.9,980,476,7,6384,6860
1.00E+12,310,124,7,1780,496,4,6624,7120
1.00E+12,310,152,7,2180,304,2,4056,4360
2.10E+12,310,54,5,1080,270,5,5130,5400
7303499,310,358,9,3980,358,1,3622,3980
1.00E+12,310,338,10,3380,676,2,6084,6760
1.00E+12,511,3740,50,7480,112200,30,112200,224400
,,,,,,,,
1.00E+12,310,1786,8.8,20300,1786,1,18514,20300
9699056,300,2500,20,12480,22500,9,89820,112320
2.10E+12,310,806,37,2180,4836,6,8244,13080
2.10E+12,100,1440,24,6000,1440,1,4560,6000
1.00E+12,500,171312,17.2,996000,342624,2,1649376,1992000
1.00E+12,310,798,10,7980,1596,2,14364,15960
2.10E+12,310,448,10,4480,1344,3,12096,13440
1.00E+12,200,396,2,19800,396,1,19404,19800
8231600,310,648,10,6480,1944,3,17496,19440
1.00E+12,310,498,10,4980,498,1,4482,4980
2.10E+12,310,298,10,2980,2682,9,24138,26820
6609427,310,881,36,2450,881,1,1569,2450
1.00E+12,100,89,10,890,623,7,5607,6230
8989814,310,468,10,4680,3744,8,33696,37440
1.00E+12,200,8932,37,24143,8932,1,15211,24143
1.00E+12,300,2000,8.7,22980,6000,3,62940,68940
1.00E+12,200,4320,8,54000,4320,1,49680,54000
6610147,310,836,28.1,2980,836,1,2144,2980
1.00E+12,310,425,19,2240,425,1,1815,2240
1.00E+12,310,3971,19,20900,3971,1,16929,20900
1.00E+12,310,2751,19,14480,2751,1,11729,14480
8434275,310,577,14.5,3980,577,1,3403,3980
6610147,100,836,28.1,2980,836,1,2144,2980
6610147,205,836,28.1,2980,836,1,2144,2980
1.00E+12,100,2751,19,14480,2751,1,11729,14480
1.00E+12,200,9906,12.7,78000,29718,3,204282,234000
1.00E+12,500,9906,12.7,78000,29718,3,204282,234000
1.00E+12,500,10000,8,124800,10000,1,114800,124800
1.00E+12,200,2933,7,41900,5866,2,77934,83800
1.00E+12,200,8400,30,28000,8400,1,19600,28000
1.00E+12,100,1166,6.9,16900,1166,1,15734,16900
1.00E+12,200,80,6.8,1180,1920,24,26400,28320
1.00E+12,310,4002,53.5,7480,8003,2,6957,14960
1.00E+12,310,315,7,4500,315,1,4185,4500
10008970,310,303,9.2,3280,303,1,2977,3280
1.00E+12,310,635,9.2,6880,635,1,6245,6880
2.10E+12,310,553,7,7900,553,1,7347,7900
1.00E+12,310,175,7,2500,175,1,2325,2500
2.10E+12,310,131,7,1880,2096,16,27984,30080
2.10E+12,310,180,7,2580,1080,6,14400,15480
1.00E+12,340,418,7,5980,418,1,5562,5980
8333576,310,182,5,3650,910,5,17340,18250
1.00E+12,310,219,5,4380,1752,8,33288,35040
1.00E+12,200,11024,20.8,53000,11024,1,41976,53000
1.00E+12,340,1678,7,23980,15102,9,200718,215820
1.00E+12,310,213,5.4,3980,213,1,3767,3980
1.00E+12,310,21,5.4,398,128,6,2260,2388
1.00E+12,310,90,5.4,1680,90,1,1590,1680
7588534,310,53,5.3,1000,53,1,947,1000
2.10E+12,310,217,7,3100,434,2,5766,6200
2.10E+12,310,348,7,4980,348,1,4632,4980
1.00E+12,200,3800,20,19000,3800,1,15200,19000
1.00E+12,310,298,10,2980,2682,9,24138,26820
1.00E+12,310,698,10,6980,698,1,6282,6980
1.00E+12,310,1390,10,13900,2780,2,25020,27800
1.00E+12,310,243,7,3480,2187,9,29133,31320
1.00E+12,310,593,7,8480,593,1,7887,8480
2.10E+12,310,1406,20.7,6800,4218,3,16182,20400
8082162,310,488,7,6980,5856,12,77904,83760
1.00E+12,310,693,7,9900,2079,3,27621,29700
2.10E+12,200,1389,26.3,5280,1389,1,3891,5280
2.10E+12,340,1389,26.3,5280,1389,1,3891,5280
8265786,340,140,7.9,1780,140,1,1640,1780
2.10E+12,340,195,7.9,2480,195,1,2285,2480
7680857,501,154,7.9,1950,154,1,1796,1950
2.10E+12,501,195,7.9,2480,195,1,2285,2480
1.00E+12,200,40240,25.3,159000,40240,1,118760,159000
1.00E+12,500,40240,25.3,159000,40240,1,118760,159000
1.00E+12,310,418,7,5980,1672,4,22248,23920
1.00E+12,310,313,7,4480,2504,8,33336,35840
1.00E+12,310,301,7,4300,1204,4,15996,17200
1.00E+12,310,273,7,3900,1092,4,14508,15600
1.00E+12,200,6784,25.6,26500,169600,25,492900,662500
1.00E+12,200,1350,5,27000,1350,1,25650,27000
1.00E+12,310,88,10,880,7127,81,64153,71280
1.00E+12,310,990,10,9900,5940,6,53460,59400
1.00E+12,310,1085,8.4,12900,1085,1,11815,12900
1.00E+12,310,40,5,800,1720,43,32680,34400
1.00E+12,310,178,5,3570,534,3,10176,10710
2.10E+12,200,1644,24,6850,4932,3,15618,20550
1.00E+12,310,2845,23.9,11900,5689,2,18111,23800
1.00E+12,310,908,4.9,18600,1815,2,35385,37200
7082034,310,277,4.9,5690,277,1,5413,5690
1.00E+12,310,648,10,6480,648,1,5832,6480
1.00E+12,310,3190,10,31900,9570,3,86130,95700
1.00E+12,310,128,10,1280,7296,57,65664,72960
9588871,310,164,5,3280,984,6,18696,19680
1.00E+12,310,990,10,9900,990,1,8910,9900
7698435,310,364,7,5200,1092,3,14508,15600
1.00E+12,310,68,6.9,980,43248,636,580032,623280
1.00E+12,310,187,7,2680,2431,13,32409,34840
1.00E+12,310,588,7.4,7980,1176,2,14784,15960
1.00E+12,310,1251,7.4,16980,1251,1,15729,16980
1.00E+12,200,13290,20.4,65000,13290,1,51710,65000
2.10E+12,200,1000,9.3,10800,6000,6,58800,64800
1.00E+12,200,8100,15,54000,8100,1,45900,54000
7882690,310,352,8.8,3980,352,1,3628,3980
1.00E+12,310,90,8.8,1020,90,1,930,1020
1.00E+12,100,518,8.9,5850,1036,2,10664,11700
1.00E+12,100,90,8.8,1020,90,1,930,1020
1.00E+12,310,174,5,3480,174,1,3306,3480
1.00E+12,310,339,5,6780,1017,3,19323,20340
1.00E+12,200,25900,20,129500,492100,19,1968400,2460500
1.00E+12,200,12150,15,81000,12150,1,68850,81000
1.00E+12,200,5560,20,27800,5560,1,22240,27800
1.00E+12,500,22751,20.5,111200,22751,1,88449,111200
1.00E+12,100,43,2,2180,86,2,4274,4360
1.00E+12,501,271,2,13580,271,1,13309,13580
1.00E+12,310,145,5,2900,145,1,2755,2900
1.00E+12,310,595,5,11900,595,1,11305,11900
1.00E+12,310,278,7,3980,2780,10,37020,39800
1.00E+12,200,3992,40,9980,3992,1,5988,9980
8023223,310,196,7,2800,784,4,10416,11200
8352220,310,131,7,1880,131,1,1749,1880
1.00E+12,310,418,7,5980,836,2,11124,11960
2.10E+12,310,278,10,2780,9452,34,85068,94520
6613885,310,133,10,1330,1064,8,9576,10640
1.00E+12,310,209,19,1100,2299,11,9801,12100
7587275,310,65,10,650,715,11,6435,7150
1.00E+12,200,5560,5,111200,5560,1,105640,111200
1.00E+12,310,5322,23.1,23000,5322,1,17678,23000
1.00E+12,310,271,3.9,6900,271,1,6629,6900
1.00E+12,340,858,10,8580,3432,4,30888,34320
1.00E+12,310,460,10,4600,11960,26,107640,119600
8605224,240,1800,40,4500,9000,5,13500,22500
1.00E+12,500,6930,19.3,36000,6930,1,29070,36000
1.00E+12,310,258,9,2880,258,1,2622,2880
2.10E+12,310,111,9,1240,111,1,1129,1240
1.00E+12,200,1590,10,15900,1590,1,14310,15900
1.00E+12,200,1079,13,8300,1079,1,7221,8300
1.00E+12,100,1147,5,22950,1147,1,21803,22950
1.00E+12,200,19800,20,99000,554400,28,2217600,2772000
1.00E+12,340,245,7,3500,490,2,6510,7000
1.00E+12,340,245,7,3500,735,3,9765,10500
1.00E+12,200,3800,10,38000,3800,1,34200,38000
1.00E+12,200,6860,10,68600,6860,1,61740,68600
7050044,310,298,10,2980,12516,42,112644,125160
1.00E+12,200,5250,15,35000,5250,1,29750,35000
2.10E+12,310,3980,31.1,12800,11940,3,26460,38400
2.10E+12,310,790,10,7900,1580,2,14220,15800
1.00E+12,310,698,10,6980,3490,5,31410,34900
1.00E+12,200,2059,20.8,9900,4118,2,15682,19800
1.00E+12,200,17500,10,175000,52500,3,472500,525000
1.00E+12,200,2850,15,19000,5700,2,32300,38000
1.00E+12,310,6916,5,138330,6916,1,131414,138330
1.00E+12,310,280,7,4000,280,1,3720,4000
8077022,310,373,7,5340,373,1,4967,5340
1.00E+12,310,552,9.9,5580,552,1,5028,5580
1.00E+12,310,25723,28.5,90300,25723,1,64577,90300
1.00E+12,200,4800,15,32000,28800,6,163200,192000
1.00E+12,100,770,10.7,7200,2310,3,19290,21600
1.00E+12,100,1102,10.7,10300,1102,1,9198,10300
1.00E+12,200,2740,12,22900,2740,1,20160,22900
1.00E+12,310,726,7,10380,726,1,9654,10380
8119682,310,118,10,1180,3894,33,35046,38940
1.00E+12,310,248,10,2480,34231,138,308009,342240
1.00E+12,100,17999,26.5,68000,17999,1,50001,68000
1.00E+12,200,2516,13.6,18500,5032,2,31968,37000
1.00E+12,200,18060,14,129000,18060,1,110940,129000
1.00E+12,200,5440,20,27200,32640,6,130560,163200
1.00E+12,310,278,10,2780,834,3,7506,8340
1.00E+12,310,768,7,10980,3072,4,40848,43920
1.00E+12,200,660,3.3,19800,660,1,19140,19800
1.00E+12,310,7332,23.5,31200,7332,1,23868,31200
1.00E+12,310,24416,28,87200,24416,1,62784,87200
1.00E+12,200,24416,28,87200,24416,1,62784,87200
1.00E+12,310,558,7,7980,2790,5,37110,39900
1.00E+12,310,558,7,7980,1116,2,14844,15960
1.00E+12,310,103,7,1480,412,4,5508,5920
1.00E+12,310,693,7,9900,1386,2,18414,19800
1.00E+12,200,5132,20.9,24500,15396,3,58104,73500
1.00E+12,300,5132,20.9,24500,15396,3,58104,73500
1.00E+12,500,1591,13.4,11870,1591,1,10279,11870
1.00E+12,310,74,5,1480,666,9,12654,13320
1.00E+12,310,44,5,880,3300,75,62700,66000
6820123,501,0,0,3150,0,2,6300,6300
8431447,310,213,9.8,2180,213,1,1967,2180
8882973,300,500,5.3,9480,1500,3,26940,28440
1.00E+12,200,251,12.6,2000,5020,20,34980,40000
1.00E+12,200,2400,8,30000,2400,1,27600,30000
1.00E+12,200,520,2,26000,520,1,25480,26000
1.00E+12,200,700,11.9,5900,700,1,5200,5900
1.00E+12,310,8918,25.5,35000,8918,1,26082,35000
1.00E+12,310,8918,25.5,35000,8918,1,26082,35000
1.00E+12,200,8918,25.5,35000,8918,1,26082,35000
1.00E+12,500,8918,25.5,35000,8918,1,26082,35000
1.00E+12,500,8918,25.5,35000,8918,1,26082,35000
9653425,310,320,7,4580,1920,6,25560,27480
1.00E+12,310,577,14.5,3980,577,1,3403,3980
7150833,310,723,14.5,4990,5061,7,29869,34930
1.00E+12,310,551,19,2900,2204,4,9396,11600
1.00E+12,310,946,19,4980,946,1,4034,4980
1.00E+12,100,509,19,2680,1018,2,4342,5360
1.00E+12,310,216,5,4320,1080,5,20520,21600
2.10E+12,200,6910,34.9,19800,20730,3,38670,59400
1.00E+12,200,4160,17.3,24000,4160,1,19840,24000
1.00E+12,100,298,10,2980,298,1,2682,2980
1.00E+12,310,724,5,14480,2172,3,41268,43440
1.00E+12,205,4296,24,17900,42960,10,136040,179000
1.00E+12,240,688,10,6880,18576,27,167184,185760
1.00E+12,340,1818,7,25980,34542,19,459078,493620
1.00E+12,200,6240,20,31200,6240,1,24960,31200
1.00E+12,240,566,19,2980,9622,17,41038,50660
2.10E+12,310,598,10,5980,5980,10,53820,59800
7345041,310,341,7,4880,682,2,9078,9760
1.00E+12,300,154,1,15490,154,1,15336,15490
2.10E+12,310,493,7.6,6480,493,1,5987,6480
1.00E+12,310,211,7.6,2780,211,1,2569,2780
1.00E+12,200,1497,12.3,12200,2994,2,21406,24400
6609557,310,185,10,1850,740,4,6660,7400
2.10E+12,310,558,10,5580,8370,15,75330,83700
1.00E+12,240,12564,46.2,27200,50256,4,58544,108800
1.00E+12,310,318,10,3180,1272,4,11448,12720
2.10E+12,310,62,5,1240,248,4,4712,4960
2.10E+12,310,1267,24,5280,12670,10,40130,52800
8333610,310,294,7,4200,7056,24,93744,100800
1.00E+12,310,68,6.9,980,3672,54,49248,52920
1.00E+12,310,274,9.9,2780,274,1,2506,2780
2.10E+12,200,690,10,6900,4830,7,43470,48300
1.00E+12,310,104,10.6,980,104,1,876,980
1.00E+12,310,745,10.7,6980,745,1,6235,6980
1.00E+12,310,4140,55.3,7480,8279,2,6681,14960
6610869,310,261,10.7,2450,261,1,2189,2450
1.00E+12,501,424,10.7,3980,424,1,3556,3980
1.00E+12,310,528,19,2780,2112,4,9008,11120
1.00E+12,100,870,19,4580,870,1,3710,4580
1.00E+12,310,20967,24.8,84500,20967,1,63533,84500
1.00E+12,310,574,9.9,5780,574,1,5206,5780
8232732,310,348,14.5,2400,1044,3,6156,7200
1.00E+12,310,1229,14.5,8480,1229,1,7251,8480
1.00E+12,310,1740,14.5,12000,3480,2,20520,24000
1.00E+12,205,894,13.8,6480,8940,10,55860,64800
1.00E+12,310,472,9.9,4780,472,1,4308,4780
1.00E+12,310,208,7,2980,3744,18,49896,53640
1.00E+12,310,418,7,5980,2090,5,27810,29900
1.00E+12,300,1500,25.1,5980,6000,4,17920,23920
1.00E+12,300,5000,29.4,16980,5000,1,11980,16980
1.00E+12,300,26385,18.4,143400,26385,1,117015,143400
1.00E+12,310,108,2.7,3980,108,1,3872,3980
9706074,310,217,2.7,7980,217,1,7763,7980
6610869,310,171,7,2450,3420,20,45580,49000
1.00E+12,310,2230,11.8,18900,2230,1,16670,18900
2.10E+12,310,9565,38.3,25000,9565,1,15435,25000
1.00E+12,200,7372,19.2,38300,7372,1,30928,38300
1.00E+12,310,50,5,1000,350,7,6650,7000
1.00E+12,310,2622,15.4,17000,7865,3,43135,51000
1.00E+12,200,2622,15.4,17000,7865,3,43135,51000
8333576,501,36,1,3650,36,1,3614,3650
8333620,501,36,1,3650,72,2,7228,7300
9708613,310,208,7,2980,624,3,8316,8940
1.00E+12,310,376,7,5380,1504,4,20016,21520
2.10E+12,310,148,10,1480,444,3,3996,4440
1.00E+12,310,102,10,1020,2448,24,22032,24480
2.10E+12,310,98,10,980,98,1,882,980
1.00E+12,205,2395,24,9980,2395,1,7585,9980
9051162,310,299,5,5980,299,1,5681,5980
1.00E+12,310,1634,8.2,19980,1634,1,18346,19980
1.00E+12,310,288,10,2880,288,1,2592,2880
2.10E+12,310,490,10,4900,4410,9,39690,44100
1.00E+12,200,505,5,10100,505,1,9595,10100
1.00E+12,310,49,5,980,735,15,13965,14700
1.00E+12,200,2040,5,40900,2040,1,38860,40900
1.00E+12,310,482,6,7980,963,2,14997,15960
1.00E+12,500,3360,9.7,34580,6720,2,62440,69160
1.00E+12,200,500,2,25000,500,1,24500,25000
1.00E+12,310,1249,20.9,5980,2498,2,9462,11960
8753741,310,99,5,1980,396,4,7524,7920
8882973,310,474,5,9480,4740,10,90060,94800
1.00E+12,205,1249,20.9,5980,2498,2,9462,11960
2.10E+12,310,2443,28,8725,36645,15,94230,130875
6609536,310,210,10,2100,2100,10,18900,21000
1.00E+12,310,398,10,3980,5572,14,50148,55720
2.10E+12,310,698,10,6980,1396,2,12564,13960
8093106,310,3328,55,6050,19965,6,16335,36300
1.00E+12,200,3610,19,19000,3610,1,15390,19000
2.10E+12,310,398,10,3980,13532,34,121788,135320
8323425,310,393,10,3930,786,2,7074,7860
1.00E+12,200,4430,6.7,66500,4430,1,62070,66500
1.00E+12,240,494,16.6,2980,1481,3,7459,8940
1.00E+12,310,357,7.3,4900,357,1,4543,4900
8225969,310,93,7.3,1280,93,1,1187,1280
1.00E+12,310,1007,7.3,13800,1007,1,12793,13800
8231547,310,89,5,1780,178,2,3382,3560
10622328,310,198,10,1980,792,4,7128,7920
1.00E+12,310,328,10,3280,328,1,2952,3280
2.10E+12,310,2660,23.2,11480,15960,6,52920,68880
2.10E+12,200,2660,23.2,11480,15960,6,52920,68880
1.00E+12,310,354,17.9,1980,354,1,1626,1980
2.10E+12,100,533,17.9,2980,533,1,2447,2980
2.10E+12,100,877,17.9,4900,877,1,4023,4900
1.00E+12,100,354,17.9,1980,354,1,1626,1980
2.10E+12,100,640,13.3,4800,640,1,4160,4800
6890809,310,648,10,6480,1296,2,11664,12960
1.00E+12,310,89,7,1280,1602,18,21438,23040
1.00E+12,310,2143,9,23900,2143,1,21757,23900
7903665,310,66,5,1330,462,7,8848,9310
2.10E+12,310,49,4.9,990,490,10,9410,9900
2.10E+12,310,84,5,1680,504,6,9576,10080
1.00E+12,310,109,10.9,1000,218,2,1782,2000
1.00E+12,310,270,10.8,2490,270,1,2220,2490
1.00E+12,310,501,10.9,4600,501,1,4099,4600
1.00E+12,100,335,10.9,3080,335,1,2745,3080
1.00E+12,100,1515,10.9,13900,1515,1,12385,13900
1.00E+12,100,651,10.9,5980,1302,2,10658,11960
1.00E+12,100,109,10.9,1000,218,2,1782,2000
1.00E+12,310,97,9.9,980,1745,18,15895,17640
1.00E+12,310,118,9.8,1200,118,1,1082,1200
8104632,310,116,9.8,1180,116,1,1064,1180
1.00E+12,310,156,9.9,1580,156,1,1424,1580
1.00E+12,200,13538,14,96700,13538,1,83162,96700
7021185,601,291,12.8,2280,291,1,1989,2280
1.00E+12,310,409,8.2,4980,409,1,4571,4980
1.00E+12,310,81,8.2,990,162,2,1818,1980
8049148,310,80,8.2,980,80,1,900,980
1.00E+12,240,1740,30,5800,5220,3,12180,17400
7095596,310,239,10,2390,11233,47,101097,112330
8265786,310,178,10,1780,1246,7,11214,12460
1.00E+12,310,470,10,4700,940,2,8460,9400
9014178,310,294,7,4200,2058,7,27342,29400
6609249,310,315,7,4500,1260,4,16740,18000
2.10E+12,200,2370,20,11850,40290,17,161160,201450
2.10E+12,601,399,5,7980,399,1,7581,7980
9077389,310,693,7,9900,693,1,9207,9900
1.00E+12,310,593,7,8480,1779,3,23661,25440
8117962,310,943,7,13480,1886,2,25074,26960
1.00E+12,310,848,10,8480,848,1,7632,8480
1.00E+12,200,6640,10,66400,6640,1,59760,66400
7095596,310,181,7.6,2390,181,1,2209,2390
1.00E+12,310,628,7,8980,1256,2,16704,17960
2.10E+12,501,100,2,5000,1000,10,49000,50000
1.00E+12,310,173,7,2480,519,3,6921,7440
1.00E+12,310,357,7,5100,714,2,9486,10200
1.00E+12,200,23750,5,475000,23750,1,451250,475000
1.00E+12,310,131500,10.8,1215000,131500,1,1083500,1215000
1.00E+12,200,2010,10,20100,2010,1,18090,20100
1.00E+12,200,660,6,11000,660,1,10340,11000
2.10E+12,200,1000,7.8,12800,11000,11,129800,140800
2.10E+12,310,358,10,3580,358,1,3222,3580
1.00E+12,200,160,2,8000,160,1,7840,8000
8315492,310,292,7,4180,876,3,11664,12540
1.00E+12,310,558,7,7980,6138,11,81642,87780
1.00E+12,310,257,7,3680,514,2,6846,7360
1.00E+12,100,2450,9.8,24900,2450,1,22450,24900
1.00E+12,205,1496,20,7480,8976,6,35904,44880
1.00E+12,310,798,10,7980,7182,9,64638,71820
1.00E+12,310,50,5,1000,150,3,2850,3000
1.00E+12,240,1014,9.4,10780,1014,1,9766,10780
1.00E+12,310,460,10,4600,920,2,8280,9200
1.00E+12,310,138,10,1380,138,1,1242,1380
8123182,310,299,7,4280,299,1,3981,4280
1.00E+12,310,1931,7.8,24900,1931,1,22969,24900
6871988,310,217,7.8,2800,651,3,7749,8400
2.10E+12,310,698,10,6980,6980,10,62820,69800
2.10E+12,310,3298,10,32980,3298,1,29682,32980
1.00E+12,310,1280,10,12800,3840,3,34560,38400
1.00E+12,310,228,10,2280,456,2,4104,4560
1.00E+12,310,60000,20,300000,60000,1,240000,300000
1.00E+12,310,184,9.3,1980,368,2,3592,3960
1.00E+12,511,1740,50,3480,66120,38,66120,132240
1.00E+12,240,822,18.3,4480,3288,4,14632,17920
1.00E+12,310,416,9.3,4480,831,2,8129,8960
1.00E+12,310,56,7,800,56,1,744,800
1.00E+12,310,3504,16.3,21500,3504,1,17996,21500
8633320,340,696,4.7,14940,1392,2,28488,29880
1.00E+12,200,17793,23.3,76300,17793,1,58507,76300
1.00E+12,310,87,9.9,880,1306,15,11894,13200
1.00E+12,205,1890,18.9,9980,1890,1,8090,9980
1.00E+12,240,706,15.8,4480,706,1,3774,4480
1.00E+12,240,197,15.8,1250,197,1,1053,1250
6842488,340,249,6.4,3900,249,1,3651,3900
1.00E+12,340,706,15.8,4480,706,1,3774,4480
1.00E+12,340,197,15.8,1250,197,1,1053,1250
7150833,310,499,10,4990,9481,19,85329,94810
1.00E+12,310,867,9.7,8980,867,1,8113,8980
1.00E+12,310,49600,25.1,198000,49600,1,148400,198000
8114123,310,1932,46,4200,3864,2,4536,8400
2.10E+12,310,187,9.9,1880,187,1,1693,1880
7642205,310,56,7,800,280,5,3720,4000
8222788,310,218,10,2180,218,1,1962,2180
9707916,310,278,10,2780,7228,26,65052,72280
6609426,310,368,10,3680,3312,9,29808,33120
1.00E+12,205,1676,20,8380,33520,20,134080,167600
1.00E+12,240,465,10,4650,3255,7,29295,32550
6610147,205,300,10.1,2980,6900,23,61640,68540
1.00E+12,205,5343,26.8,19900,10686,2,29114,39800
1.00E+12,340,858,10,8580,5148,6,46332,51480
1.00E+12,310,2730,7,39000,2730,1,36270,39000
1.00E+12,310,5250,7,75000,5250,1,69750,75000
8484691,310,458,10,4580,458,1,4122,4580
1.00E+12,310,292,7,4180,1168,4,15552,16720
8328977,310,49,5,980,980,20,18620,19600
1.00E+12,310,395,5,7900,10270,26,195130,205400
1.00E+12,310,149,5,2980,298,2,5662,5960
2.10E+12,310,249,5,4980,747,3,14193,14940
6609426,310,184,5,3680,1104,6,20976,22080
6609430,310,112,5,2250,1120,10,21380,22500
7534834,100,830,10,8300,830,1,7470,8300
1.00E+12,310,328,10,3280,656,2,5904,6560
1.00E+12,310,790,10,7900,1580,2,14220,15800
1.00E+12,200,14065,14.5,97000,14065,1,82935,97000
1.00E+12,310,3071,9.7,31500,6142,2,56858,63000
1.00E+12,200,3071,9.7,31500,6142,2,56858,63000
1.00E+12,310,41900,28.1,149000,41900,1,107100,149000
2.10E+12,310,149,5,2980,745,5,14155,14900
6608992,310,458,10,4580,916,2,8244,9160
10627392,310,432,10,4320,2160,5,19440,21600
1.00E+12,200,4100,9.3,43900,28700,7,278600,307300
1.00E+12,310,120,8,1500,239,2,2761,3000
2.10E+12,200,4000,25.3,15800,20000,5,59000,79000
1.00E+12,310,74,5,1480,666,9,12654,13320
1.00E+12,310,314,5,6280,6280,20,119320,125600
6610177,310,315,7,4500,315,1,4185,4500
1.00E+12,310,32770,21.6,151800,32770,1,119030,151800
1.00E+12,200,32770,21.6,151800,32770,1,119030,151800
1.00E+12,200,25416,12,211800,25416,1,186384,211800
1.00E+12,310,988,10,9880,1976,2,17784,19760
2.10E+12,310,2268,28,8100,11340,5,29160,40500
2.10E+12,200,1498,25.1,5980,1498,1,4482,5980
2.10E+12,205,2090,38.1,5480,2090,1,3390,5480
2.10E+12,310,99,5,1980,99,1,1881,1980
1.00E+12,240,798,10,7980,1596,2,14364,15960
1.00E+12,310,312,3.1,9980,312,1,9668,9980
6977207,310,55,3.1,1780,55,1,1725,1780
1.00E+12,310,27,3.1,880,82,3,2558,2640
8223610,310,296,3.1,9480,296,1,9184,9480
7499006,310,28,3.1,900,28,1,872,900
2.10E+12,200,3245,25,12980,35695,11,107085,142780
4239495,200,12470,14.5,86000,12470,1,73530,86000
1.00E+12,310,99,5,1980,396,4,7524,7920
1.00E+12,310,848,10,8480,7632,9,68688,76320
1.00E+12,200,1440,10,14400,1440,1,12960,14400
1.00E+12,310,198,8.7,2280,396,2,4164,4560
2.10E+12,310,328,8.7,3780,328,1,3452,3780
1.00E+12,501,23,1,2380,46,2,4714,4760
2.10E+12,501,128,1,12800,128,1,12672,12800
1.00E+12,501,0,0,1980,0,2,3960,3960
1.00E+12,340,103,7,1480,206,2,2754,2960
1.00E+12,310,164,5,3280,164,1,3116,3280
1.00E+12,310,49,5,980,735,15,13965,14700
1.00E+12,501,5816,20.1,29000,5816,1,23184,29000
2.10E+12,310,9461,23.2,40800,9461,1,31339,40800
1.00E+12,310,97,9.9,980,291,3,2649,2940
1.00E+12,310,345,9.9,3480,345,1,3135,3480
1.00E+12,310,1090,10,10900,1090,1,9810,10900
1.00E+12,310,465,19,2450,7905,17,33745,41650
2.10E+12,200,14430,37,39000,28860,2,49140,78000
1.00E+12,310,65,5,1300,65,1,1235,1300
1.00E+12,511,3927,52.5,7480,15708,4,14212,29920
1.00E+12,310,244,9.5,2580,488,2,4672,5160
1.00E+12,310,1590,10,15900,1590,1,14310,15900
2.10E+12,310,918,28,3280,918,1,2362,3280
1.00E+12,310,166,7,2380,166,1,2214,2380
1.00E+12,310,485,16.3,2980,5820,12,29940,35760
1.00E+12,310,72,9,800,434,6,4366,4800
1.00E+12,310,224,9,2480,224,1,2256,2480
9700881,310,270,9.1,2980,270,1,2710,2980
8333648,240,613,18.1,3380,613,1,2767,3380
1.00E+12,310,298,10,2980,298,1,2682,2980
1.00E+12,310,680,10,6800,2720,4,24480,27200
78916,310,36703,20.6,178000,36703,1,141297,178000
2.10E+12,310,698,10,6980,1396,2,12564,13960
2.10E+12,310,298,10,2980,1192,4,10728,11920
1.00E+12,310,288,9.7,2980,288,1,2692,2980
8097965,310,628,9.7,6480,628,1,5852,6480
1.00E+12,310,191,9.6,1980,191,1,1789,1980
8694843,310,482,9.7,4980,482,1,4498,4980
1.00E+12,310,482,9.7,4980,482,1,4498,4980
6864891,310,337,9.7,3480,337,1,3143,3480
1.00E+12,310,600,10,6000,600,1,5400,6000
1.00E+12,310,875,10,8750,1750,2,15750,17500
1.00E+12,310,5930,14.5,40900,5930,1,34970,40900
10008698,310,398,10,3980,398,1,3582,3980
1.00E+12,310,35,10,350,1050,30,9450,10500
1.00E+12,511,2392,40,5980,7176,3,10764,17940
8333645,340,65,6.8,950,195,3,2655,2850
1.00E+12,310,148,10,1480,148,1,1332,1480
1.00E+12,310,398,10,3980,398,1,3582,3980
1.00E+12,310,1629,11.5,14200,1629,1,12571,14200
1.00E+12,310,2055,8.7,23500,4110,2,42890,47000
1.00E+12,310,1580,20,7900,1580,1,6320,7900
2.10E+12,200,1845,18.8,9800,1845,1,7955,9800
1.00E+12,310,274,5,5480,1644,6,31236,32880
1.00E+12,200,21450,23.3,92000,21450,1,70550,92000
1.00E+12,500,21450,23.3,92000,21450,1,70550,92000
1.00E+12,500,24650,24.9,99000,24650,1,74350,99000
1.00E+12,300,7750,20.9,37000,7750,1,29250,37000
2.10E+12,200,2386,35.2,6780,2386,1,4394,6780
2.10E+12,310,292,9,3250,292,1,2958,3250
2.10E+12,310,718,9,7980,718,1,7262,7980
1.00E+12,310,673,9,7480,673,1,6807,7480
1.00E+12,310,256,8.9,2880,256,1,2624,2880
1.00E+12,310,266,8.9,2980,531,2,5429,5960
1.00E+12,310,390,8.9,4380,390,1,3990,4380
1.00E+12,310,87,8.9,980,174,2,1786,1960
1.00E+12,310,15745,23.5,67000,15745,1,51255,67000
1.00E+12,500,26646,26.5,100500,26646,1,73854,100500
2.10E+12,310,109,9.5,1150,1087,10,10413,11500
1.00E+12,310,1464,13.6,10780,1464,1,9316,10780
1.00E+12,340,8960,25.6,35000,8960,1,26040,35000
6883116,310,245,5,4900,245,1,4655,4900
1.00E+12,310,461,14.5,3180,3227,7,19033,22260
1.00E+12,200,7960,14.5,54900,7960,1,46940,54900
1.00E+12,500,16576,22.4,74000,16576,1,57424,74000
1.00E+12,240,5871,19,30900,5871,1,25029,30900
2.10E+12,310,56,7.7,730,56,1,674,730
1.00E+12,310,585,4.9,11980,585,1,11395,11980
9656160,310,140,4.9,2880,280,2,5480,5760
7021920,310,47,4.8,980,47,1,933,980
2.10E+12,200,1388,23.2,5980,1388,1,4592,5980
9071394,310,468,10,4680,7020,15,63180,70200
1.00E+12,310,248,10,2480,1488,6,13392,14880
1.00E+12,310,198,10,1980,396,2,3564,3960
8491731,310,252,7,3600,1008,4,13392,14400
1.00E+12,310,499,5,9980,2994,6,56886,59880
1.00E+12,100,3270,10.9,30000,16350,5,133650,150000
1.00E+12,310,110,7,1580,220,2,2940,3160
2.10E+12,310,194,7,2780,1164,6,15516,16680
6615133,310,179,7,2570,1611,9,21519,23130
1.00E+12,310,756,7,10800,3024,4,40176,43200
1.00E+12,310,120,10,1200,2639,22,23761,26400
1.00E+12,310,258,10,2580,258,1,2322,2580
1.00E+12,310,268,10,2680,268,1,2412,2680
1.00E+12,310,789,5,15790,1578,2,30002,31580
1.00E+12,200,1100,11,10000,4400,4,35600,40000
2.10E+12,310,1918,28,6850,5754,3,14796,20550
2.10E+12,200,1918,28,6850,5754,3,14796,20550
2.10E+12,310,890,10,8900,1780,2,16020,17800
2.10E+12,310,2175,37,5880,60900,28,103740,164640
1.00E+12,240,604,19,3180,6644,11,28336,34980
1.00E+12,310,388,10,3880,3104,8,27936,31040
1.00E+12,310,299,5,5980,598,2,11362,11960
1.00E+12,310,16450,23.5,70000,49350,3,160650,210000
8040010,240,1680,40,4200,6720,4,10080,16800
7073040,300,996,20,4980,14940,15,59760,74700
1.00E+12,200,2976,31,9600,2976,1,6624,9600
8562095,310,189,5,3780,1323,7,25137,26460
7051239,310,135,7,1940,810,6,10830,11640
2.10E+12,310,124,5,2480,1240,10,23560,24800
9067456,310,108,6.8,1580,108,1,1472,1580
1.00E+12,310,227,22.7,1000,227,1,773,1000
1.00E+12,310,722,14.5,4980,722,1,4258,4980
1.00E+12,310,49,5,980,294,6,5586,5880
8333658,310,192,5,3850,576,3,10974,11550
1.00E+12,310,258,10,2580,3096,12,27864,30960
1.00E+12,310,648,10,6480,1296,2,11664,12960
1.00E+12,310,898,10,8980,1796,2,16164,17960
2.10E+12,200,360,30,1200,360,1,840,1200
1.00E+12,601,722,14.5,4980,722,1,4258,4980
1.00E+12,240,697,17.5,3980,2092,3,9848,11940
1.00E+12,100,424,5,8480,424,1,8056,8480
9526010,310,79,10,790,1975,25,17775,19750
1.00E+12,500,31200,7.4,424000,31200,1,392800,424000
2.10E+12,340,418,7,5980,418,1,5562,5980
10627392,340,302,7,4320,302,1,4018,4320
1.00E+12,310,2086,19,10980,4172,2,17788,21960
1.00E+12,100,756,19,3980,756,1,3224,3980
1.00E+12,310,648,5.9,10900,648,1,10252,10900
1.00E+12,310,294,5.9,4950,294,1,4656,4950
2.10E+12,310,2480,15.7,15800,7440,3,39960,47400
1.00E+12,205,2070,30,6900,33120,16,77280,110400
10051303,310,848,10,8480,5936,7,53424,59360
1.00E+12,310,328,10,3280,328,1,2952,3280
2.10E+12,200,2480,15.7,15800,7440,3,39960,47400
8976246,310,78,10,780,21060,270,189540,210600
7275221,240,398,10,3980,8756,22,78804,87560
1.00E+12,310,699,11.7,6000,699,1,5301,6000
1.00E+12,310,577,14.5,3980,577,1,3403,3980
1.00E+12,310,1311,19,6900,2622,2,11178,13800
1.00E+12,200,2960,20,14800,5920,2,23680,29600
1.00E+12,200,5757,16,36000,5757,1,30243,36000
1.00E+12,340,9118,25.3,36000,9118,1,26882,36000
8583141,310,384,10,3840,384,1,3456,3840
1.00E+12,200,720,10,7200,2160,3,19440,21600
1.00E+12,310,617,8.8,6980,617,1,6363,6980
1.00E+12,200,8559,15.9,54000,8559,1,45441,54000
1.00E+12,300,8559,15.9,54000,8559,1,45441,54000
1.00E+12,310,179,6.2,2880,179,1,2701,2880
1.00E+12,310,2380,20,11900,2380,1,9520,11900
1.00E+12,205,2100,23.4,8980,21000,10,68800,89800
1.00E+12,310,98,10,980,98,1,882,980
1.00E+12,310,298,10,2980,298,1,2682,2980
1.00E+12,310,466,9.4,4980,466,1,4514,4980
1.00E+12,310,1649,9.4,17500,1649,1,15851,17500
1.00E+12,310,1286,18.4,6980,1286,1,5694,6980
2.10E+12,310,279,9.4,2980,279,1,2701,2980
2.10E+12,205,2003,36.6,5480,2003,1,3477,5480
1.00E+12,205,1286,18.4,6980,1286,1,5694,6980
1.00E+12,200,30694,28.7,107100,30694,1,76406,107100
1.00E+12,310,114,7,1640,114,1,1526,1640
1.00E+12,310,399,5,7980,1197,3,22743,23940
1.00E+12,511,738,53.5,1380,4428,6,3852,8280
2.10E+12,310,498,10,4980,6474,13,58266,64740
2.10E+12,310,427,19.4,2200,427,1,1773,2200
2.10E+12,310,7392,37,19980,59136,8,100704,159840
2.10E+12,310,288,17.8,1620,1728,6,7992,9720
8844794,310,198,10,1980,2970,15,26730,29700
2.10E+12,200,427,19.4,2200,427,1,1773,2200
6609525,310,89,7,1280,89,1,1191,1280
1.00E+12,310,55008,19,290000,55008,1,234992,290000
1.00E+12,310,119,5,2390,238,2,4542,4780
2.10E+12,310,2170,18.9,11480,2170,1,9310,11480
2.10E+12,310,999,5,19980,1998,2,37962,39960
1.00E+12,300,3488,8,43600,6976,2,80224,87200
2.10E+12,310,589,6.3,9400,589,1,8811,9400
2.10E+12,310,1054,6.3,16800,1054,1,15746,16800
1.00E+12,240,350,11.7,2980,700,2,5260,5960
1.00E+12,240,351,11.8,2980,1052,3,7888,8940
1.00E+12,200,7840,8,98000,7840,1,90160,98000
1.00E+12,310,292,7,4180,584,2,7776,8360
1.00E+12,500,41692,24.7,169000,41692,1,127308,169000
8090958,310,188,10,1880,1316,7,11844,13160
1.00E+12,310,128,10,1280,2176,17,19584,21760
1.00E+12,310,3036,10,30360,3036,1,27324,30360
1.00E+12,310,598,10,5980,598,1,5382,5980
1.00E+12,310,2880,10,28800,2880,1,25920,28800
1.00E+12,310,374,5,7480,1122,3,21318,22440
1.00E+12,310,4680,9.4,49800,4680,1,45120,49800
1.00E+12,310,138,10,1380,2208,16,19872,22080
1.00E+12,310,149,5,2980,1192,8,22648,23840
10698740,310,424,5,8480,3816,9,72504,76320
10733698,310,250,7,3580,250,1,3330,3580
1.00E+12,310,895,5,17900,895,1,17005,17900
2.10E+12,205,1969,33.5,5880,21659,11,43021,64680
1.00E+12,340,155,6.3,2480,155,1,2325,2480
1.00E+12,205,1125,16.1,6980,1125,1,5855,6980
1.00E+12,310,10431,11.6,90000,10431,1,79569,90000
1.00E+12,310,138,10,1380,276,2,2484,2760
1.00E+12,200,55304,30.9,179000,55304,1,123696,179000
8258298,310,2590,10,25900,2590,1,23310,25900
1.00E+12,601,399,5,7980,399,1,7581,7980
1.00E+12,511,2950,50,5900,11800,4,11800,23600
2.10E+12,200,1000,16.7,5980,5000,5,24900,29900
6612784,310,548,10,5480,2192,4,19728,21920
1.00E+12,200,245,5,4900,245,1,4655,4900
10622328,310,138,7,1980,552,4,7368,7920
2.10E+12,310,8436,20.7,40800,75924,9,291276,367200
2.10E+12,310,278,7,3980,278,1,3702,3980
1.00E+12,310,142,5,2850,426,3,8124,8550
1.00E+12,310,79,5,1580,316,4,6004,6320
7333368,310,424,5,8480,848,2,16112,16960
8069951,240,1220,13.6,9000,1220,1,7780,9000
8039735,310,210,10,2100,7770,37,69930,77700
1.00E+12,300,148,1,14800,148,1,14652,14800
1.00E+12,310,1017,53.5,1900,2033,2,1767,3800
1.00E+12,310,418,7,5980,836,2,11124,11960
1.00E+12,100,1081,24.7,4380,3244,3,9896,13140
1.00E+12,100,6561,13.2,49800,6561,1,43239,49800
1.00E+12,310,127,3.6,3480,127,1,3353,3480
1.00E+12,310,205,6.9,2980,205,1,2775,2980
1.00E+12,100,198,6.9,2880,198,1,2682,2880
6839974,100,89,6.8,1300,534,6,7266,7800
10701325,310,308,6.9,4480,308,1,4172,4480
1.00E+12,310,425,6.9,6180,425,1,5755,6180
1.00E+12,500,32320,20.5,158000,32320,1,125680,158000
1.00E+12,310,698,10,6980,1396,2,12564,13960
1.00E+12,310,698,10,6980,698,1,6282,6980
1.00E+12,200,1190,3,39900,1190,1,38710,39900
1.00E+12,500,1190,3,39900,1190,1,38710,39900
1.00E+12,100,2740,14.5,18900,2740,1,16160,18900
1.00E+12,501,2740,14.5,18900,2740,1,16160,18900
1.00E+12,310,8150,16.3,50000,8150,1,41850,50000
1.00E+12,310,1698,10,16980,3396,2,30564,33960
1.00E+12,310,1598,10,15980,3196,2,28764,31960
1.00E+12,310,749,5,14980,749,1,14231,14980
6615615,340,196,7,2800,392,2,5208,5600
1.00E+12,310,1562,11.3,13830,1562,1,12268,13830
1.00E+12,310,1516,12.1,12500,1516,1,10984,12500
1.00E+12,200,1562,11.3,13830,1562,1,12268,13830
1.00E+12,310,3498,10,34980,3498,1,31482,34980
1.00E+12,340,68,6.9,980,136,2,1824,1960
6609755,340,418,7,5980,418,1,5562,5980
1.00E+12,340,257,7,3680,771,3,10269,11040
1.00E+12,200,6966,18,38700,6966,1,31734,38700
1.00E+12,310,243,7,3480,486,2,6474,6960
1.00E+12,310,596,8.5,6980,596,1,6384,6980
1.00E+12,310,599,8.6,7000,1798,3,19202,21000
8333648,240,550,16.3,3380,5500,10,28300,33800
2.10E+12,200,1918,28,6850,7672,4,19728,27400
1.00E+12,200,21260,7.8,270900,21260,1,249640,270900
1.00E+12,200,10550,22.1,47790,10550,1,37240,47790
1.00E+12,500,9430,19.2,49000,18860,2,79140,98000
1.00E+12,310,58,10,580,696,12,6264,6960
1.00E+12,200,3256,22.5,14500,3256,1,11244,14500
1.00E+12,200,7800,15,52000,46800,6,265200,312000
1.00E+12,310,3844,11.6,33000,3844,1,29156,33000
1.00E+12,310,1864,11.7,16000,1864,1,14136,16000
1.00E+12,500,1864,11.7,16000,1864,1,14136,16000
8632217,340,383,7,5480,383,1,5097,5480
1.00E+12,340,1118,7,15980,1118,1,14862,15980
1.00E+12,340,488,7,6980,488,1,6492,6980
1.00E+12,340,698,7,9980,698,1,9282,9980
1.00E+12,501,3188,10.7,29800,3188,1,26612,29800
1.00E+12,310,199,5,3980,199,1,3781,3980
1.00E+12,310,199,5,3980,398,2,7562,7960
7348243,200,4978,11.3,43900,19912,4,155688,175600
1.00E+12,200,8400,15,56050,8400,1,47650,56050
1.00E+12,310,955,9.6,9980,955,1,9025,9980
1.00E+12,310,249,5,4980,1245,5,23655,24900
7296003,601,156,14.4,1080,156,1,924,1080
1.00E+12,310,432,14.5,2980,432,1,2548,2980
1.00E+12,310,432,14.5,2980,432,1,2548,2980
1.00E+12,310,798,10,7980,4788,6,43092,47880
1.00E+12,500,2654,23.3,11400,2654,1,8746,11400
1.00E+12,310,833,7,11900,1666,2,22134,23800
1.00E+12,200,3780,6,63000,3780,1,59220,63000
1.00E+12,200,1800,12,15000,3600,2,26400,30000
1.00E+12,205,8160,30,27200,24480,3,57120,81600
1.00E+12,310,706,7.9,8980,706,1,8274,8980
1.00E+12,310,392,7.9,4980,783,2,9177,9960
1.00E+12,200,1480,5.5,26800,4440,3,75960,80400
1.00E+12,300,6219,20.8,29900,6219,1,23681,29900
10223492,310,639,8.5,7480,639,1,6841,7480
10626914,310,1537,8.5,17980,1537,1,16443,17980
1.00E+12,200,2460,8,30750,2460,1,28290,30750
2.10E+12,310,586,7,8380,1758,3,23382,25140
2.10E+12,310,488,7,6980,976,2,12984,13960
2.10E+12,310,488,7,6980,488,1,6492,6980
2.10E+12,200,1776,20.9,8480,7104,4,26816,33920
1.00E+12,310,394,5,7880,788,2,14972,15760
1.00E+12,310,999,5,19980,999,1,18981,19980
1.00E+12,200,1600,10,16000,1600,1,14400,16000
1.00E+12,200,1900,10,19000,1900,1,17100,19000
1.00E+12,310,249,5,4980,249,1,4731,4980
10354262,310,149,5,2980,745,5,14155,14900
2.10E+12,310,139,5,2780,3614,26,68666,72280
6609540,310,149,5,2980,1043,7,19817,20860
1.00E+12,100,3927,52.5,7480,7854,2,7106,14960
1.00E+12,100,3927,52.5,7480,7854,2,7106,14960
1.00E+12,310,60,5,1200,480,8,9120,9600
6613854,601,711,14.3,4980,711,1,4269,4980
2.10E+12,200,1331,22.3,5980,1331,1,4649,5980
1.00E+12,300,3855,5.9,64800,11565,3,182835,194400
1.00E+12,310,398,10,3980,398,1,3582,3980
1.00E+12,200,7260,6,121000,7260,1,113740,121000
1.00E+12,310,49,5,980,196,4,3724,3920
1.00E+12,310,540,5,10800,2700,5,51300,54000
1.00E+12,500,1090,5,21800,1090,1,20710,21800
8562071,310,648,10,6480,3240,5,29160,32400
2.10E+12,200,3568,32.5,10980,14272,4,29648,43920
1.00E+12,205,10110,30,33700,30330,3,70770,101100
1.00E+12,310,1978,18.3,10780,1978,1,8802,10780
1.00E+12,310,199,10,1990,199,1,1791,1990
1.00E+12,310,148,10,1480,740,5,6660,7400
1.00E+12,340,88,4.4,1980,88,1,1892,1980
1.00E+12,500,1750,5,35000,1750,1,33250,35000
10530218,310,69,7,990,621,9,8289,8910
1.00E+12,501,83,2,4180,83,1,4097,4180
1.00E+12,310,372,7.5,4980,372,1,4608,4980
1.00E+12,310,222,7.4,2980,444,2,5516,5960
1.00E+12,300,2000,11.8,16980,2000,1,14980,16980
1.00E+12,310,513,8.5,6000,1025,2,10975,12000
1.00E+12,310,290,7.3,3980,290,1,3690,3980
1.00E+12,601,355,11.9,2980,355,1,2625,2980
2.10E+12,205,1863,10.1,18500,1863,1,16637,18500
1.00E+12,310,498,10,4980,996,2,8964,9960
2.10E+12,200,1000,14.7,6800,5000,5,29000,34000
9014185,310,192,5,3840,384,2,7296,7680
1.00E+12,240,11972,46.8,25600,47888,4,54512,102400
1.00E+12,205,11972,46.8,25600,47888,4,54512,102400
1.00E+12,200,3900,15,26000,3900,1,22100,26000
1.00E+12,310,167,5.6,2980,167,1,2813,2980
8892518,310,288,5.6,5120,288,1,4832,5120
1.00E+12,310,3990,10,39900,3990,1,35910,39900
8892518,310,512,10,5120,512,1,4608,5120
1.00E+12,310,199,5,3980,398,2,7562,7960
1.00E+12,310,7009,16.3,43000,7009,1,35991,43000
1.00E+12,310,322,8.9,3600,322,1,3278,3600
1.00E+12,310,299,9,3340,897,3,9123,10020
8362808,310,119,7,1700,476,4,6324,6800
1.00E+12,310,154,7,2200,154,1,2046,2200
7103444,310,119,10,1190,476,4,4284,4760
1.00E+12,310,256,10,2560,1024,4,9216,10240
1.00E+12,310,798,10,7980,4788,6,43092,47880
8120848,310,99,10,990,7722,78,69498,77220
1.00E+12,200,8184,20.5,40000,8184,1,31816,40000
1.00E+12,100,650,10,6500,650,1,5850,6500
7628565,310,657,16.9,3880,657,1,3223,3880
1.00E+12,310,308,12.3,2500,308,1,2192,2500
1.00E+12,310,268,12.3,2180,268,1,1912,2180
1.00E+12,100,737,12.3,5980,737,1,5243,5980
1.00E+12,100,663,33.5,1980,663,1,1317,1980
6610147,205,487,16.3,2980,6331,13,32409,38740
8333576,340,255,7,3650,255,1,3395,3650
1.00E+12,310,2075,26,7980,2075,1,5905,7980
1.00E+12,310,435,8.9,4900,435,1,4465,4900
1.00E+12,310,708,8.9,7980,708,1,7272,7980
8568431,310,379,8.9,4280,379,1,3901,4280
2.10E+12,310,4390,26,16900,4390,1,12510,16900
1.00E+12,500,9988,18.8,53200,9988,1,43212,53200
2.10E+12,310,4440,34.7,12800,4440,1,8360,12800
7349751,310,334,10,3340,2004,6,18036,20040
6616349,310,520,10,5200,1560,3,14040,15600
1.00E+12,310,124,7,1780,372,3,4968,5340
9645642,200,190,5,3800,190,1,3610,3800
1.00E+12,310,5840,59,9900,17520,3,12180,29700
1.00E+12,310,330,14.5,2280,330,1,1950,2280
1.00E+12,310,564,23,2450,564,1,1886,2450
1.00E+12,310,394,9.7,4050,788,2,7312,8100
2.10E+12,310,427,9.7,4380,427,1,3953,4380
1.00E+12,100,5840,59,9900,17520,3,12180,29700
1.00E+12,100,564,23,2450,564,1,1886,2450
7707170,240,1023,18.3,5580,1023,1,4557,5580
2.10E+12,310,2094,16.4,12800,2094,1,10706,12800
10235666,310,109,9.2,1180,109,1,1071,1180
1.00E+12,310,918,9.3,9900,918,1,8982,9900
1.00E+12,200,3179,37.4,8500,9536,3,15964,25500
1.00E+12,310,1887,37,5100,7548,4,12852,20400
2.10E+12,310,288,17.8,1620,5184,18,23976,29160
2.10E+12,200,288,17.8,1620,5184,18,23976,29160
2.10E+12,200,643,32.5,1980,1286,2,2674,3960
2.10E+12,200,2994,30,9980,38922,13,90818,129740
1.00E+12,310,198,10,1980,990,5,8910,9900
9071499,310,1034,7,14780,1034,1,13746,14780
1.00E+12,200,2283,11.6,19600,2283,1,17317,19600
1.00E+12,310,1870,10,18700,1870,1,16830,18700
1.00E+12,240,237,19,1250,6162,26,26338,32500
1.00E+12,200,1340,8.1,16500,2680,2,30320,33000
1.00E+12,200,8000,8,100000,8000,1,92000,100000
1.00E+12,310,754,9.4,7980,754,1,7226,7980
1.00E+12,310,470,9.4,4980,470,1,4510,4980
1.00E+12,200,16410,15,109420,32820,2,186020,218840
7350960,511,1550,39.2,3950,6200,4,9600,15800
6942752,310,855,19,4500,1710,2,7290,9000
1.00E+12,100,228,19,1200,456,2,1944,2400
1.00E+12,200,7020,18,39000,7020,1,31980,39000
1.00E+12,310,174,14.5,1200,1392,8,8208,9600
1.00E+12,200,1820,3.3,54900,1820,1,53080,54900
1.00E+12,310,385,7,5500,385,1,5115,5500
6609437,310,180,7,2580,1440,8,19200,20640
1.00E+12,200,1040,7,14900,1040,1,13860,14900
1.00E+12,501,8415,12.3,68300,33660,4,239540,273200
1.00E+12,310,235,9.6,2450,235,1,2215,2450
1.00E+12,310,48,9.6,500,96,2,904,1000
1.00E+12,310,479,9.6,4980,479,1,4501,4980
1.00E+12,200,1509,17.8,8500,1509,1,6991,8500
1.00E+12,200,8840,16.6,53100,8840,1,44260,53100
1.00E+12,310,19975,10,199500,19975,1,179525,199500
2.10E+12,100,1258,11.6,10800,1258,1,9542,10800
1.00E+12,340,1555,24,6480,1555,1,4925,6480
1.00E+12,310,190,10,1900,760,4,6840,7600
2.10E+12,310,348,7,4980,1740,5,23160,24900
1.00E+12,310,91,6.3,1450,91,1,1359,1450
1.00E+12,310,251,6.3,3980,251,1,3729,3980
1.00E+12,310,377,6.3,5980,377,1,5603,5980
6609411,310,214,5,4280,642,3,12198,12840
2.10E+12,100,6221,17.9,34800,6221,1,28579,34800
1.00E+12,500,16761,15.5,108000,16761,1,91239,108000
2.10E+12,200,2970,30,9900,2970,1,6930,9900
1.00E+12,200,2744,28,9800,2744,1,7056,9800
1.00E+12,310,398,10,3980,398,1,3582,3980
2.10E+12,310,222,7.2,3100,222,1,2878,3100
1.00E+12,310,369,5,7380,369,1,7011,7380
1.00E+12,310,1106,7,15800,1106,1,14694,15800
6609258,310,271,7,3880,813,3,10827,11640
1.00E+12,310,68,6.9,980,339,5,4561,4900
1.00E+12,200,1200,10,12000,1200,1,10800,12000
2.10E+12,310,2093,28,7475,2093,1,5382,7475
1.00E+12,310,798,10,7980,1596,2,14364,15960
10229292,310,398,10,3980,4776,12,42984,47760
1.00E+12,310,314,7.9,3980,628,2,7332,7960
1.00E+12,310,386,7.9,4880,386,1,4494,4880
8065514,310,309,7.9,3900,309,1,3591,3900
1.00E+12,310,69,7.8,880,345,5,4055,4400
6613777,100,118,7.9,1500,118,1,1382,1500
1.00E+12,100,467,7.9,5900,467,1,5433,5900
1.00E+12,501,235,7.9,2980,705,3,8235,8940
1.00E+12,310,142,5.7,2480,142,1,2338,2480
10219983,310,23,5.7,398,137,6,2251,2388
9035816,310,172,5,3450,516,3,9834,10350
1.00E+12,200,11357,19.2,59000,11357,1,47643,59000
1.00E+12,310,407,8.2,4980,407,1,4573,4980
1.00E+12,310,198,10,1980,990,5,8910,9900
1.00E+12,310,100000,7.7,1299000,100000,1,1199000,1299000
2.10E+12,310,208,7,2980,4160,20,55440,59600
8333552,310,234,5,4680,234,1,4446,4680
1.00E+12,310,103,7,1480,4738,46,63342,68080
1.00E+12,205,1200,30,4000,1200,1,2800,4000
1.00E+12,205,2700,30,9000,2700,1,6300,9000
1.00E+12,205,1200,30,4000,1200,1,2800,4000
1.00E+12,200,1980,10,19800,1980,1,17820,19800
1.00E+12,310,1640,54.7,3000,1640,1,1360,3000
1.00E+12,200,1640,54.7,3000,1640,1,1360,3000
1.00E+12,501,743,13.8,5400,743,1,4657,5400
8076920,310,483,7,6900,483,1,6417,6900
2.10E+12,310,756,7,10800,9828,13,130572,140400
1.00E+12,310,273,7,3900,546,2,7254,7800
1.00E+12,310,229,5,4580,1603,7,30457,32060
2.10E+12,310,249,5,4980,996,4,18924,19920
2.10E+12,200,1390,15.8,8800,2780,2,14820,17600
1.00E+12,310,1772,27.3,6480,1772,1,4708,6480
2.10E+12,310,825,9.2,8980,825,1,8155,8980
1.00E+12,310,181,9.1,1980,181,1,1799,1980
1.00E+12,310,549,9.2,5980,549,1,5431,5980
1.00E+12,240,1498,27.3,5480,1498,1,3982,5480
7081031,310,139,12.6,1100,139,1,961,1100
1.00E+12,100,480,17.3,2780,480,1,2300,2780
1.00E+12,100,761,12.7,6000,761,1,5239,6000
8083283,100,855,17.3,4950,855,1,4095,4950
1.00E+12,310,180,10,1800,180,1,1620,1800
8594928,310,97,5,1950,1164,12,22236,23400
1.00E+12,310,79,5,1580,1343,17,25517,26860
1.00E+12,200,198,3,6600,198,1,6402,6600
9592840,310,418,9.3,4480,418,1,4062,4480
1.00E+12,310,652,9.3,6980,1304,2,12656,13960
2.10E+12,310,1415,26.8,5280,1415,1,3865,5280
8797930,310,1704,43.7,3900,1704,1,2196,3900
1.00E+12,310,799,10,7990,799,1,7191,7990
1.00E+12,310,448,10,4480,448,1,4032,4480
1.00E+12,240,1680,40,4200,18480,11,27720,46200
1.00E+12,310,598,4.8,12400,598,1,11802,12400
2.10E+12,310,241,4.8,4980,481,2,9479,9960
1.00E+12,310,478,4.8,9900,478,1,9422,9900
1.00E+12,310,409,4.8,8480,409,1,8071,8480
1.00E+12,310,580,10,5800,580,1,5220,5800
1.00E+12,310,2337,13.8,16900,2337,1,14563,16900
2.10E+12,310,1769,8.9,19980,1769,1,18211,19980
1.00E+12,310,1324,37,3580,27804,21,47376,75180
1.00E+12,310,1324,37,3580,34424,26,58656,93080
1.00E+12,310,384,10,3840,3840,10,34560,38400
7343883,340,517,7,7390,517,1,6873,7390
6609752,310,748,10,7480,2244,3,20196,22440
6609434,310,538,10,5380,1614,3,14526,16140
2.10E+12,200,2320,20,11600,18560,8,74240,92800
1.00E+12,205,5357,37.7,14200,10714,2,17686,28400
1.00E+12,340,1386,7,19800,1386,1,18414,19800
1.00E+12,100,56509,33.8,167300,56509,1,110791,167300
1.00E+12,310,798,10,7980,798,1,7182,7980
1.00E+12,200,14240,20,71200,14240,1,56960,71200
1.00E+12,200,195,5,3900,390,2,7410,7800
1.00E+12,205,10064,37,27200,10064,1,17136,27200
9604300,310,798,10,7980,3990,5,35910,39900
2.10E+12,310,1918,28,6850,7672,4,19728,27400
1.00E+12,310,668,10,6680,2672,4,24048,26720
1.00E+12,310,249,5,4980,249,1,4731,4980
10351081,310,199,5,3980,398,2,7562,7960
1.00E+12,310,420,9.4,4480,839,2,8121,8960
2.10E+12,310,2712,18.4,14700,5424,2,23976,29400
6609571,310,166,7,2380,332,2,4428,4760
1.00E+12,310,488,7,6980,1952,4,25968,27920
10733698,310,358,10,3580,358,1,3222,3580
7073945,310,390,10,3900,1170,3,10530,11700
1.00E+12,310,2399,6,39900,2399,1,37501,39900
1.00E+12,310,717,6,11980,717,1,11263,11980
7291156,310,328,10,3280,1968,6,17712,19680
7022265,310,238,10,2380,476,2,4284,4760
1.00E+12,310,39,5,780,78,2,1482,1560
1.00E+12,310,99,5,1980,198,2,3762,3960
1.00E+12,310,70,7,1000,1120,16,14880,16000
7150833,100,249,5,4990,249,1,4741,4990
1.00E+12,240,4967,50.2,9900,29800,6,29600,59400
2.10E+12,310,1397,7.6,18500,1397,1,17103,18500
1.00E+12,310,1646,7.6,21800,1646,1,20154,21800
1.00E+12,240,859,13.3,6480,1718,2,11242,12960
1.00E+12,100,386,5.9,6500,772,2,12228,13000
1.00E+12,501,859,13.3,6480,1718,2,11242,12960
1.00E+12,200,15900,10,159000,31800,2,286200,318000
1.00E+12,310,6656,20.8,32000,13312,2,50688,64000
1.00E+12,310,280,7,4000,840,3,11160,12000
6890809,310,453,7,6480,453,1,6027,6480
1.00E+12,240,448,10,4480,1344,3,12096,13440
1.00E+12,200,5655,14.5,39000,5655,1,33345,39000
1.00E+12,240,1490,50,2980,34270,23,34270,68540
7647948,310,815,10,8150,815,1,7335,8150
1.00E+12,340,15872,25.6,62000,31744,2,92256,124000
1.00E+12,310,687,6.1,11200,687,1,10513,11200
9054179,310,244,6.1,3980,244,1,3736,3980
1.00E+12,310,367,6.1,5980,367,1,5613,5980
1.00E+12,310,468,37.4,1250,468,1,782,1250
1.00E+12,310,1215,43.7,2780,2429,2,3131,5560
1.00E+12,310,315,11.8,2680,315,1,2365,2680
8642235,501,764,11.8,6480,764,1,5716,6480
1.00E+12,501,433,11.8,3680,433,1,3247,3680
1.00E+12,501,4416,55.9,7900,8832,2,6968,15800
1.00E+12,200,15974,16.3,98000,15974,1,82026,98000
1.00E+12,240,946,28,3380,1892,2,4868,6760
1.00E+12,310,2133,7,30480,6399,3,85041,91440
1.00E+12,240,2090,10,20900,8360,4,75240,83600
1.00E+12,310,99,10,990,2574,26,23166,25740
2.10E+12,200,1918,28,6850,5754,3,14796,20550
1.00E+12,205,2790,28.2,9900,5580,2,14220,19800
,,,,,,,,
1.00E+12,310,74,5,1480,74,1,1406,1480
1.00E+12,310,4150,10,41500,4150,1,37350,41500
1.00E+12,200,6700,12.4,54000,6700,1,47300,54000
1.00E+12,310,132,5,2650,264,2,5036,5300
2.10E+12,310,345,5,6900,690,2,13110,13800
1.00E+12,100,1087,14.5,7500,1087,1,6413,7500
1.00E+12,501,609,14.5,4200,609,1,3591,4200
1.00E+12,200,1450,16.3,8900,1450,1,7450,8900
1.00E+12,310,499,21,2380,499,1,1881,2380
1.00E+12,310,114,5,2280,684,6,12996,13680
1.00E+12,511,5670,57.3,9900,22680,4,16920,39600
2.10E+12,310,458,10,4580,1374,3,12366,13740
1.00E+12,310,5670,57.3,9900,22680,4,16920,39600
2.10E+12,100,390,10,3900,390,1,3510,3900
1.00E+12,310,700,10,7000,700,1,6300,7000
1.00E+12,200,4500,5,90000,4500,1,85500,90000
1.00E+12,310,149,5,2980,596,4,11324,11920
8023504,310,189,5,3780,189,1,3591,3780
1.00E+12,310,862,8.7,9900,862,1,9038,9900
1.00E+12,100,3150,7,45000,3150,1,41850,45000
2.10E+12,310,1698,21.3,7980,1698,1,6282,7980
2.10E+12,310,662,10,6620,662,1,5958,6620
1.00E+12,200,3825,15,25500,3825,1,21675,25500
8022385,310,1253,7,17900,1253,1,16647,17900
1.00E+12,601,149,5,2980,149,1,2831,2980
1.00E+12,310,1888,7,26980,1888,1,25092,26980
1.00E+12,310,530,7,7580,530,1,7050,7580
10354262,310,208,7,2980,416,2,5544,5960
8362410,310,212,5,4250,212,1,4038,4250
2.10E+12,501,109,1,10980,109,1,10871,10980
8488475,501,70,1,7000,70,1,6930,7000
6618348,501,49,1,4950,98,2,9802,9900
1.00E+12,310,124,5,2480,496,4,9424,9920
1.00E+12,310,849,5,16980,1698,2,32262,33960
10532297,310,501,9.1,5480,501,1,4979,5480
1.00E+12,200,1130,19,5950,2260,2,9640,11900
1.00E+12,310,833,7,11900,833,1,11067,11900
1.00E+12,240,4838,25.6,18900,9676,2,28124,37800
8232043,310,110,7,1580,110,1,1470,1580
1.00E+12,310,799,5,15980,799,1,15181,15980
1.00E+12,310,248,5,4960,496,2,9424,9920
1.00E+12,310,149,5,2980,298,2,5662,5960
1.00E+12,200,16695,15,111300,16695,1,94605,111300
8626811,340,383,7,5480,766,2,10194,10960
1.00E+12,340,586,7,8380,586,1,7794,8380
1.00E+12,310,19980,20,99900,19980,1,79920,99900
2.10E+12,200,1913,25.6,7475,9565,5,27810,37375
1.00E+12,200,11550,15,77000,11550,1,65450,77000
1.00E+12,300,6070,20.9,29000,6070,1,22930,29000
1.00E+12,310,279,7,3990,558,2,7422,7980
1.00E+12,100,4568,10.7,42700,4568,1,38132,42700
1.00E+12,300,4280,16.3,26300,4280,1,22020,26300
6835815,310,198,10,1980,6732,34,60588,67320
1.00E+12,300,22050,27.5,80100,22050,1,58050,80100
1.00E+12,300,9720,24,40500,9720,1,30780,40500
1.00E+12,200,22650,16.3,139000,22650,1,116350,139000
1.00E+12,200,30800,16.3,189000,30800,1,158200,189000
1.00E+12,300,30800,16.3,189000,30800,1,158200,189000
1.00E+12,300,12430,26,47790,24860,2,70720,95580
1.00E+12,300,670,25.3,2650,2680,4,7920,10600
2.10E+12,310,399,16.3,2450,798,2,4102,4900
1.00E+12,310,566,19,2980,1132,2,4828,5960
9655526,310,148,10,1480,740,5,6660,7400
1.00E+12,240,566,19,2980,1132,2,4828,5960
1.00E+12,240,490,19,2580,490,1,2090,2580
1.00E+12,200,7665,15,51100,22995,3,130305,153300
1.00E+12,200,4914,14,35100,4914,1,30186,35100
1.00E+12,200,5205,14.5,35900,5205,1,30695,35900
1.00E+12,200,2232,26.9,8300,2232,1,6068,8300
1.00E+12,100,4168,26.9,15500,4168,1,11332,15500
1.00E+12,200,4168,26.9,15500,4168,1,11332,15500
7648614,601,47,4.9,950,235,5,4515,4750
1.00E+12,310,498,10,4980,1494,3,13446,14940
2.10E+12,310,1280,10,12800,14080,11,126720,140800
1.00E+12,511,4450,50,8900,8900,2,8900,17800
1.00E+12,310,334,7,4780,334,1,4446,4780
1.00E+12,310,257,7,3680,2570,10,34230,36800
8117928,310,348,7,4980,696,2,9264,9960
1.00E+12,200,3248,10.9,29800,3248,1,26552,29800
2.10E+12,310,337,7,4816,1011,3,13437,14448
7580677,310,257,8.6,2980,514,2,5446,5960
1.00E+12,310,343,8.6,3980,686,2,7274,7960
1.00E+12,200,4200,15,28000,4200,1,23800,28000
2.10E+12,200,200,11.4,1750,2600,13,20150,22750
10370463,310,251,7.9,3180,251,1,2929,3180
1.00E+12,310,275,7.9,3480,275,1,3205,3480
1.00E+12,310,76,7.8,980,76,1,904,980
1.00E+12,205,8350,30.7,27200,8350,1,18850,27200
7903665,501,105,7.9,1330,210,2,2450,2660
1.00E+12,501,314,7.9,3980,314,1,3666,3980
7073240,501,137,7.9,1740,137,1,1603,1740
1.00E+12,310,7451,14.6,51000,7451,1,43549,51000
1.00E+12,310,399,5,7980,798,2,15162,15960
1.00E+12,310,139,5,2780,1807,13,34333,36140
2.10E+12,240,2165,36.2,5980,4329,2,7631,11960
2.10E+12,310,956,8.9,10800,1912,2,19688,21600
2.10E+12,310,1795,5,35900,1795,1,34105,35900
1.00E+12,500,31833,23.3,136500,31833,1,104667,136500
1.00E+12,310,685,6.9,9900,1370,2,18430,19800
7050041,310,206,6.9,2980,1031,5,13869,14900
2.10E+12,310,1770,20.3,8700,1770,1,6930,8700
2.10E+12,200,4000,28.8,13900,40000,10,99000,139000
1.00E+12,310,490,10,4900,490,1,4410,4900
1.00E+12,310,306,7,4380,2754,9,36666,39420
1.00E+12,200,14086,21.7,65000,14086,1,50914,65000
1.00E+12,310,347,11.6,2980,694,2,5266,5960
6835815,100,230,11.6,1980,230,1,1750,1980
1.00E+12,300,3000,17.3,17380,84000,28,402640,486640
907389,310,27260,14.5,188000,27260,1,160740,188000
1.00E+12,310,198,10,1980,594,3,5346,5940
1.00E+12,310,428,10,4280,856,2,7704,8560
1.00E+12,310,224,9,2500,224,1,2276,2500
1.00E+12,310,132,8.9,1480,132,1,1348,1480
1.00E+12,100,87,8.9,980,87,1,893,980
1.00E+12,100,806,9,8980,806,1,8174,8980
1.00E+12,100,224,9,2500,224,1,2276,2500
1.00E+12,501,204,9,2280,1226,6,12454,13680
1.00E+12,501,132,8.9,1480,132,1,1348,1480
1.00E+12,501,179,9,2000,179,1,1821,2000
1.00E+12,501,88,8.9,990,88,1,902,990
10528713,310,1398,10,13980,1398,1,12582,13980
1.00E+12,310,600,7,8580,1200,2,15960,17160
1.00E+12,300,1500,9.7,15480,4500,3,41940,46440
1.00E+12,500,10530,17.6,60000,21060,2,98940,120000
2.10E+12,240,7853,22.4,35000,15706,2,54294,70000
2.10E+12,310,1856,14.5,12800,1856,1,10944,12800
2.10E+12,100,403,14.5,2780,806,2,4754,5560
10007742,310,753,9.4,7980,753,1,7227,7980
1.00E+12,310,1291,18.5,6980,1291,1,5689,6980
1.00E+12,200,2340,12,19500,2340,1,17160,19500
2.10E+12,100,1720,31.4,5480,1720,1,3760,5480
1.00E+12,310,498,10,4980,4482,9,40338,44820
1.00E+12,310,348,10,3480,696,2,6264,6960
1.00E+12,200,10430,10,104300,10430,1,93870,104300
1.00E+12,200,680,5,13600,1360,2,25840,27200
1.00E+12,200,775,5,15500,775,1,14725,15500
1.00E+12,100,128,10,1280,768,6,6912,7680
1.00E+12,310,398,10,3980,2388,6,21492,23880
8642235,310,324,5,6480,324,1,6156,6480
2.10E+12,501,99,1,9900,99,1,9801,9900
6835815,501,19,1,1980,19,1,1961,1980
9704172,501,74,1,7480,74,1,7406,7480
2.10E+12,501,0,0,260,0,20,5200,5200
2.10E+12,501,607,30.7,1980,607,1,1373,1980
1.00E+12,310,855,14.5,5900,855,1,5045,5900
1.00E+12,310,3333,9.7,34500,10000,3,93500,103500
6615248,310,224,9.7,2300,224,1,2076,2300
1.00E+12,310,1652,9.8,16900,1652,1,15248,16900
8333411,601,47,4.9,950,47,1,903,950
1.00E+12,200,4600,10,46000,9200,2,82800,92000
1.00E+12,200,1295,5,25900,1295,1,24605,25900
1.00E+12,511,1541,53.5,2880,27729,18,24111,51840
6610189,310,47,5,940,94,2,1786,1880
1.00E+12,200,33180,31.6,105000,33180,1,71820,105000
1.00E+12,310,304,5,6080,608,2,11552,12160
2.10E+12,200,1380,20,6900,5520,4,22080,27600
1.00E+12,240,485,16.3,2980,2910,6,14970,17880
2.10E+12,310,1526,7,21800,1526,1,20274,21800
1.00E+12,310,336,10,3360,336,1,3024,3360
1.00E+12,205,1188,18.3,6480,2376,2,10584,12960
1.00E+12,200,6120,15,40800,24480,4,138720,163200
1.00E+12,310,37,9.6,390,749,20,7051,7800
1.00E+12,310,718,9.6,7480,718,1,6762,7480
1.00E+12,310,480,10,4800,480,1,4320,4800
1.00E+12,340,348,7,4980,348,1,4632,4980
1.00E+12,340,404,7,5780,404,1,5376,5780
1.00E+12,200,525,5,10500,525,1,9975,10500
1.00E+12,200,6840,19,36000,6840,1,29160,36000
1.00E+12,310,453,7,6480,453,1,6027,6480
1.00E+12,310,208,7,2980,416,2,5544,5960
1.00E+12,200,1290,14.5,8900,1290,1,7610,8900
1.00E+12,310,1790,10,17900,1790,1,16110,17900
2.10E+12,501,10214,25,40800,10214,1,30586,40800
2.10E+12,501,374,11.8,3180,374,1,2806,3180
1.00E+12,340,338,7.9,4280,338,1,3942,4280
2.10E+12,501,420,7.9,5300,420,1,4880,5300
2.10E+12,200,661,19,3480,16525,25,70475,87000
2.10E+12,205,3018,23.4,12900,3018,1,9882,12900
1.00E+12,310,3089,14.1,21900,3089,1,18811,21900
1.00E+12,310,131,9.5,1380,131,1,1249,1380
1.00E+12,200,864,6,14400,864,1,13536,14400
2.10E+12,200,4044,27.3,14800,4044,1,10756,14800
1.00E+12,100,2962,18.8,15780,2962,1,12818,15780
1.00E+12,500,14040,17.6,80000,14040,1,65960,80000
2.10E+12,310,1817,18.5,9800,1817,1,7983,9800
2.10E+12,310,1817,18.4,9900,1817,1,8083,9900
1.00E+12,200,14850,15,99000,14850,1,84150,99000
1.00E+12,200,8730,18.5,47200,34920,4,153880,188800
1.00E+12,200,2350,5,47000,4700,2,89300,94000
1.00E+12,500,6060,20.2,30000,199980,33,790020,990000
1.00E+12,200,5800,10,58000,5800,1,52200,58000
1.00E+12,200,31750,5,635000,31750,1,603250,635000
1.00E+12,310,1896,3.5,53865,1896,1,51969,53865
1.00E+12,200,5252,13.2,39900,5252,1,34648,39900
9014185,100,418,10.9,3840,418,1,3422,3840
8844794,100,215,10.9,1980,215,1,1765,1980
2.10E+12,200,8646,37.6,22980,8646,1,14334,22980
2.10E+12,501,1290,10,12900,1290,1,11610,12900
2.10E+12,501,8646,37.6,22980,8646,1,14334,22980
1.00E+12,240,410,11.4,3600,410,1,3190,3600
1.00E+12,310,60,5,1200,900,15,17100,18000
1.00E+12,310,158,10,1580,474,3,4266,4740
8119682,310,116,9.8,1180,347,3,3193,3540
1.00E+12,310,117,9.8,1200,351,3,3249,3600
1.00E+12,200,16520,22.1,74800,16520,1,58280,74800
1.00E+12,310,264,7,3780,528,2,7032,7560
2.10E+12,310,208,7,2980,1456,7,19404,20860
8068378,310,258,10,2580,258,1,2322,2580
2.10E+12,310,480,10,4800,1440,3,12960,14400
1.00E+12,310,70,5,1400,210,3,3990,4200
6614233,100,247,10.8,2280,247,1,2033,2280
1.00E+12,501,99,10,990,297,3,2673,2970
1.00E+12,501,29,2,1480,87,3,4353,4440
1.00E+12,200,5230,15,34900,5230,1,29670,34900
2.10E+12,310,1890,10,18900,1890,1,17010,18900
6610923,310,378,10,3780,378,1,3402,3780
1.00E+12,310,1198,10,11980,1198,1,10782,11980
1.00E+12,200,15409,17.1,90300,15409,1,74891,90300
1.00E+12,310,598,10,5980,598,1,5382,5980
1.00E+12,340,226,5.7,3980,226,1,3754,3980
1.00E+12,340,308,37.1,830,2772,9,4698,7470
8730117,340,904,5.7,15900,904,1,14996,15900
6835821,310,99,5,1980,594,6,11286,11880
10051303,310,424,5,8480,1696,4,32224,33920
1.00E+12,310,23100,19.3,120000,23100,1,96900,120000
,,,,,,,,
1.00E+12,310,9660,7,138000,9660,1,128340,138000
1.00E+12,200,6890,5.5,124200,6890,1,117310,124200
7348242,310,6886,15.7,43900,6886,1,37014,43900
7348242,200,6886,15.7,43900,6886,1,37014,43900
7431876,310,144,5,2880,144,1,2736,2880
1.00E+12,310,49,4.9,990,147,3,2823,2970
1.00E+12,340,498,10,4980,996,2,8964,9960
1.00E+12,200,1710,5,34200,1710,1,32490,34200
1.00E+12,310,209,5,4180,209,1,3971,4180
2.10E+12,200,4718,35,13480,47180,10,87620,134800
2.10E+12,601,405,11.6,3480,405,1,3075,3480
10232951,310,144,6.6,2180,144,1,2036,2180
1.00E+12,200,98600,17,580000,98600,1,481400,580000
1.00E+12,200,294,6,4900,588,2,9212,9800
1.00E+12,310,301,13.8,2180,602,2,3758,4360
8364050,310,304,13.8,2200,304,1,1896,2200
2.10E+12,310,1379,13.8,9980,1379,1,8601,9980
1.00E+12,310,914,18.4,4980,914,1,4066,4980
6610188,100,173,18.4,940,345,2,1535,1880
1.00E+12,100,964,13.8,6980,964,1,6016,6980
2.10E+12,200,8347,44,18980,8347,1,10633,18980
1.00E+12,200,2330,11.1,21000,4660,2,37340,42000
2.10E+12,310,35,7,500,2100,60,27900,30000
6615161,310,648,10,6480,1296,2,11664,12960
1.00E+12,200,3900,15,26000,3900,1,22100,26000
1.00E+12,200,1150,12,9600,4600,4,33800,38400
1.00E+12,310,429,9.5,4500,429,1,4071,4500
6621714,310,666,9.5,6980,666,1,6314,6980
1.00E+12,310,466,9.4,4980,932,2,9028,9960
1.00E+12,200,1330,8.1,16350,1330,1,15020,16350
1.00E+12,310,388,10,3880,8148,21,73332,81480
1.00E+12,310,108,10,1080,108,1,972,1080
1.00E+12,200,4800,15,32000,9600,2,54400,64000
1.00E+12,200,5603,16.5,34000,5603,1,28397,34000
1.00E+12,310,542,10.9,4980,1084,2,8876,9960
1.00E+12,310,248,10,2480,248,1,2232,2480
1.00E+12,310,324,10.9,2980,324,1,2656,2980
7150833,100,543,10.9,4990,543,1,4447,4990
6835815,501,215,10.9,1980,215,1,1765,1980
1.00E+12,501,324,10.9,2980,324,1,2656,2980
1.00E+12,501,1351,10.9,12400,1351,1,11049,12400
1.00E+12,501,817,10.9,7500,817,1,6683,7500
6609038,310,126,7,1800,756,6,10044,10800
1.00E+12,310,252,9.3,2700,252,1,2448,2700
1.00E+12,310,651,9.3,6980,651,1,6329,6980
1.00E+12,310,54626,20.6,265000,109252,2,420748,530000
1.00E+12,310,169,9,1880,507,3,5133,5640
1.00E+12,310,215,9,2390,645,3,6525,7170
1.00E+12,100,60,2,3000,60,1,2940,3000
2.10E+12,310,918,28,3280,1836,2,4724,6560
6848652,205,2070,30,6900,8280,4,19320,27600
2.10E+12,205,918,28,3280,1836,2,4724,6560
6609438,310,129,5,2580,516,4,9804,10320
1.00E+12,310,74,5,1480,518,7,9842,10360
1.00E+12,310,198,10,1980,198,1,1782,1980
1.00E+12,310,99,10,990,693,7,6237,6930
2.10E+12,200,1278,25.7,4980,2556,2,7404,9960
1.00E+12,310,1080,10,10800,1080,1,9720,10800
8327658,310,298,10,2980,1490,5,13410,14900
7049663,310,518,10,5180,518,1,4662,5180
7540567,310,398,10,3980,1990,5,17910,19900
7234761,310,117,5.9,1980,117,1,1863,1980
1.00E+12,310,146,5.9,2480,146,1,2334,2480
1.00E+12,100,827,5.9,13900,827,1,13073,13900
1.00E+12,501,827,5.9,13900,827,1,13073,13900
2.10E+12,310,301,14.5,2080,301,1,1779,2080
2.10E+12,310,243,14.5,1680,243,1,1437,1680
7693530,100,648,16.3,3980,1296,2,6664,7960
6615115,100,766,16.3,4700,1532,2,7868,9400
2.10E+12,340,131,7,1880,262,2,3498,3760
6610050,511,2170,54.5,3980,4339,2,3621,7960
1.00E+12,310,549,9,6080,549,1,5531,6080
7134845,310,350,9,3880,350,1,3530,3880
1.00E+12,310,206,9,2280,1647,8,16593,18240
1.00E+12,200,7223,27.3,26500,7223,1,19277,26500
7915523,310,224,5,4480,448,2,8512,8960
1.00E+12,200,12920,17,76000,12920,1,63080,76000
1.00E+12,240,594,30,1980,594,1,1386,1980
1.00E+12,310,491,9.9,4980,491,1,4489,4980
2.10E+12,310,351,8.1,4350,351,1,3999,4350
8076918,310,888,8.1,10980,888,1,10092,10980
6835815,100,136,6.9,1980,136,1,1844,1980
2.10E+12,100,99,2,4980,99,1,4881,4980
2.10E+12,200,1370,20,6850,8220,6,32880,41100
1.00E+12,310,413,7,5900,826,2,10974,11800
1.00E+12,310,180,7,2580,360,2,4800,5160
1.00E+12,310,243,7,3480,729,3,9711,10440
1.00E+12,200,1971,9,21900,7884,4,79716,87600
2.10E+12,310,875,40.1,2180,875,1,1305,2180
2.10E+12,310,185,14.5,1280,370,2,2190,2560
1.00E+12,310,186,19,980,186,1,794,980
2.10E+12,100,577,14.5,3980,577,1,3403,3980
2.10E+12,100,105,14.4,730,210,2,1250,1460
1.00E+12,100,547,19,2880,547,1,2333,2880
8886655,100,428,10,4280,428,1,3852,4280
10732906,100,174,5,3480,174,1,3306,3480
2.10E+12,310,504,14.5,3480,3528,7,20832,24360
2.10E+12,310,299,5,5980,299,1,5681,5980
1.00E+12,310,349,6.6,5280,349,1,4931,5280
1.00E+12,310,656,6.6,9900,1968,3,27732,29700
1.00E+12,310,329,6.6,4980,329,1,4651,4980
1.00E+12,310,99280,26.7,372000,99280,1,272720,372000
1.00E+12,500,99280,26.7,372000,99280,1,272720,372000
1.00E+12,601,577,14.5,3980,577,1,3403,3980
1.00E+12,310,398,10,3980,1592,4,14328,15920
1.00E+12,200,11578,20.2,57320,11578,1,45742,57320
1.00E+12,310,630,7,9000,1260,2,16740,18000
8549264,310,297,7,4250,594,2,7906,8500
8103649,310,187,7.9,2380,187,1,2193,2380
1.00E+12,310,354,7.9,4480,354,1,4126,4480
1.00E+12,100,711,7.9,8980,711,1,8269,8980
1.00E+12,501,412,7.9,5200,412,1,4788,5200
8103649,501,187,7.9,2380,187,1,2193,2380
1.00E+12,100,3262,11.7,28000,3262,1,24738,28000
,,,,,,,,
5777965,500,12636,17.6,72000,12636,1,59364,72000
,,,,,,,,
1.00E+12,310,1158,10,11580,3474,3,31266,34740
1.00E+12,310,138,7,1980,276,2,3684,3960
1.00E+12,310,198,10,1980,1980,10,17820,19800
2.10E+12,310,555,5.7,9800,555,1,9245,9800
2.10E+12,200,367,15,2450,367,1,2083,2450
1.00E+12,200,2452,18.3,13400,4904,2,21896,26800
1.00E+12,200,5014,18.3,27400,5014,1,22386,27400
,,,,,,,,
1.00E+12,200,4500,10,45000,9000,2,81000,90000
2.10E+12,310,3069,24,12800,3069,1,9731,12800
2.10E+12,310,592,9.9,5980,1184,2,10776,11960
1.00E+12,310,1069,9.9,10800,1069,1,9731,10800
2.10E+12,200,3069,24,12800,3069,1,9731,12800
1.00E+12,310,18797,12.2,154000,18797,1,135203,154000
1.00E+12,200,7960,12.8,62100,7960,1,54140,62100
1.00E+12,200,7960,15,53100,7960,1,45140,53100
1.00E+12,200,520,13,4000,1560,3,10440,12000
1.00E+12,310,8859,19.3,46000,17718,2,74282,92000
1.00E+12,200,540,5,10800,1620,3,30780,32400
1.00E+12,200,2480,8,31000,4960,2,57040,62000
1.00E+12,310,1186,4.1,28980,1186,1,27794,28980
1.00E+12,310,228,4.1,5580,228,1,5352,5580
1.00E+12,310,367,4.1,8980,367,1,8613,8980
1.00E+12,310,259,9,2880,259,1,2621,2880
1.00E+12,310,332,9,3680,332,1,3348,3680
1.00E+12,310,950,10,9500,2850,3,25650,28500
1.00E+12,310,2923,37,7900,5846,2,9954,15800
1.00E+12,310,2923,37,7900,5846,2,9954,15800
1.00E+12,310,978,7,13980,1956,2,26004,27960
1.00E+12,310,883,9.2,9580,883,1,8697,9580
1.00E+12,310,687,8.5,8100,687,1,7413,8100
1.00E+12,310,287,14.5,1980,1148,4,6772,7920
8029615,310,400,10,4000,800,2,7200,8000
8886936,310,288,10,2880,2304,8,20736,23040
1.00E+12,310,650,10,6500,1950,3,17550,19500
1.00E+12,310,14640,23.5,62300,14640,1,47660,62300
8531750,310,315,7,4500,2205,7,29295,31500
1.00E+12,310,110,7,1580,550,5,7350,7900
1.00E+12,310,8424,24,35100,16848,2,53352,70200
1.00E+12,310,3022,9.7,31000,3022,1,27978,31000
7513645,310,358,10,3580,7160,20,64440,71600
2.10E+12,310,128,6.5,1980,128,1,1852,1980
1.00E+12,310,648,6.5,9980,648,1,9332,9980
8082162,310,453,6.5,6980,906,2,13054,13960
6608988,310,164,5,3280,328,2,6232,6560
1.00E+12,310,114,5,2280,1482,13,28158,29640
1.00E+12,310,460,7,6580,460,1,6120,6580
6617357,310,2373,7,33900,2373,1,31527,33900
1.00E+12,310,298,10,2980,298,1,2682,2980
2.10E+12,200,6693,33.5,19980,26772,4,53148,79920
1.00E+12,310,137,9.2,1480,273,2,2687,2960
1.00E+12,310,99,5,1980,693,7,13167,13860
1.00E+12,310,15,4.8,310,1200,80,23600,24800
1.00E+12,310,374,5,7480,374,1,7106,7480
2.10E+12,200,140,8.6,1620,1960,14,20720,22680
1.00E+12,200,246418,13.6,1811900,246418,1,1565482,1811900
1.00E+12,310,3431,14.4,23900,3431,1,20469,23900
1.00E+12,310,234,9.8,2380,234,1,2146,2380
8232773,310,238,9.6,2480,238,1,2242,2480
1.00E+12,200,1766,14.1,12500,1766,1,10734,12500
1.00E+12,310,890,5,17800,890,1,16910,17800
1.00E+12,310,99,5,1980,99,1,1881,1980
2.10E+12,200,1370,20,6850,13700,10,54800,68500
1.00E+12,205,12453,41,30400,37360,3,53840,91200
1.00E+12,310,2112,13.4,15780,2112,1,13668,15780
2.10E+12,310,919,30.8,2980,1837,2,4123,5960
2.10E+12,200,919,30.8,2980,1837,2,4123,5960
1.00E+12,200,7903,26.3,30000,15806,2,44194,60000
1.00E+12,500,10557,6.9,153000,10557,1,142443,153000
1.00E+12,511,1440,50,2880,23040,16,23040,46080
1.00E+12,310,119,5,2380,238,2,4522,4760
1.00E+12,310,83,5,1670,332,4,6348,6680
1.00E+12,310,1198,10,11980,1198,1,10782,11980
1.00E+12,310,189,5,3780,567,3,10773,11340
1.00E+12,300,3000,14.3,20980,3000,1,17980,20980
7187324,310,344,5,6880,1376,4,26144,27520
2.10E+12,310,1918,28,6850,1918,1,4932,6850
1.00E+12,310,691,7,9880,691,1,9189,9880
1.00E+12,310,625,7,8940,625,1,8315,8940
1.00E+12,240,1470,35,4200,1470,1,2730,4200
7150086,310,298,10,2980,596,2,5364,5960
7479645,310,428,10,4280,2996,7,26964,29960
1.00E+12,310,2380,20,11900,2380,1,9520,11900
1.00E+12,200,3400,10,34000,3400,1,30600,34000
1.00E+12,100,598,10,5980,598,1,5382,5980
1.00E+12,310,418,7,5980,836,2,11124,11960
1.00E+12,310,348,7,4980,696,2,9264,9960
1.00E+12,310,1480,10,14800,2960,2,26640,29600
2.10E+12,310,1480,10,14800,8880,6,79920,88800
7707168,310,598,10,5980,4784,8,43056,47840
2.10E+12,310,938,23.6,3980,3752,4,12168,15920
1.00E+12,310,4604,11.4,40500,4604,1,35896,40500
1.00E+12,200,5900,10,59000,5900,1,53100,59000
1.00E+12,310,488,7,6980,488,1,6492,6980
7150833,310,550,11,4990,550,1,4440,4990
1.00E+12,310,227,6.3,3580,227,1,3353,3580
1.00E+12,601,660,11,5980,660,1,5320,5980
7150833,601,550,11,4990,550,1,4440,4990
2.10E+12,310,438,10,4380,1314,3,11826,13140
2.10E+12,310,946,28,3380,946,1,2434,3380
10535320,310,198,10,1980,198,1,1782,1980
2.10E+12,310,398,10,3980,2786,7,25074,27860
1.00E+12,310,383,9.6,3980,766,2,7194,7960
1.00E+12,310,327,9.1,3600,327,1,3273,3600
8023223,310,254,9.1,2800,254,1,2546,2800
1.00E+12,310,362,9.1,3980,362,1,3618,3980
6615244,340,126,7,1800,252,2,3348,3600
6616789,310,278,10,2780,1390,5,12510,13900
1.00E+12,310,254,6.7,3780,254,1,3526,3780
1.00E+12,310,136,6.9,1980,136,1,1844,1980
2.10E+12,200,596,30.1,1980,596,1,1384,1980
1.00E+12,501,315,6.9,4580,315,1,4265,4580
9051273,501,225,6.9,3280,225,1,3055,3280
2.10E+12,501,1908,34.8,5480,1908,1,3572,5480
1.00E+12,310,6407,11.6,55000,6407,1,48593,55000
1.00E+12,300,7106,16.3,43600,7106,1,36494,43600
8083329,310,269,5,5380,538,2,10222,10760
1.00E+12,310,798,10,7980,11970,15,107730,119700
2.10E+12,310,324,5,6480,324,1,6156,6480
2.10E+12,310,199,5,3980,1194,6,22686,23880
1.00E+12,310,114,5,2280,228,2,4332,4560
1.00E+12,310,1338,12.4,10780,2675,2,18885,21560
1.00E+12,310,32,8.1,390,632,20,7168,7800
10532571,310,647,8.1,7980,647,1,7333,7980
2.10E+12,310,310,10,3100,620,2,5580,6200
1.00E+12,310,287,14.5,1980,574,2,3386,3960
1.00E+12,310,287,14.5,1980,574,2,3386,3960
1.00E+12,310,745,5,14900,745,1,14155,14900
7688157,310,249,5,4980,249,1,4731,4980
1.00E+12,310,795,5,15900,795,1,15105,15900
1.00E+12,310,165,5,3300,495,3,9405,9900
1.00E+12,310,84,7,1200,336,4,4464,4800
1.00E+12,511,360,33.3,1080,7560,21,15120,22680
1.00E+12,200,9204,11.8,78000,9204,1,68796,78000
1.00E+12,501,9204,11.8,78000,9204,1,68796,78000
6829364,240,2086,28,7450,2086,1,5364,7450
7891089,601,99,5,1980,297,3,5643,5940
1.00E+12,205,620,17.2,3600,1240,2,5960,7200
8500033,310,548,10,5480,548,1,4932,5480
6845379,310,419,10,4190,419,1,3771,4190
1.00E+12,310,323,9.2,3500,323,1,3177,3500
6820123,310,291,9.2,3150,291,1,2859,3150
6609807,240,836,20,4180,7524,9,30096,37620
1.00E+12,310,680,8.5,7980,680,1,7300,7980
1.00E+12,310,348,7,4980,696,2,9264,9960
9595786,310,251,6.3,3980,251,1,3729,3980
1.00E+12,200,1566,14.5,10800,1566,1,9234,10800
1.00E+12,200,10886,17.9,60750,21772,2,99728,121500
9077389,340,693,7,9900,2079,3,27621,29700
7460695,310,593,10,5930,1186,2,10674,11860
8279084,310,298,10,2980,1192,4,10728,11920
10732906,310,348,10,3480,2436,7,21924,24360
2.10E+12,601,1491,11.6,12800,1491,1,11309,12800
1.00E+12,310,1840,11.6,15800,5520,3,41880,47400
2.10E+12,310,138,7,1980,414,3,5526,5940
2.10E+12,310,928,14.5,6400,928,1,5472,6400
2.10E+12,310,990,10,9900,4950,5,44550,49500
1.00E+12,300,2953,4,74400,2953,1,71447,74400
1.00E+12,200,6241,13.9,45000,6241,1,38759,45000
1.00E+12,200,596,4,14900,596,1,14304,14900
1.00E+12,310,1798,10,17980,5394,3,48546,53940
1.00E+12,310,548,10,5480,3288,6,29592,32880
1.00E+12,200,1144,13,8800,1144,1,7656,8800
1.00E+12,310,599,5,11980,599,1,11381,11980
6834866,310,156,10,1560,624,4,5616,6240
6801265,310,398,10,3980,398,1,3582,3980
1.00E+12,200,10010,19.3,52000,30030,3,125970,156000
1.00E+12,310,124,4.8,2580,247,2,4913,5160
1.00E+12,310,117,3.4,3480,234,2,6726,6960
6609408,310,134,3.4,3980,134,1,3846,3980
1.00E+12,310,127,3.3,3800,127,1,3673,3800
1.00E+12,310,336,3.4,9980,336,1,9644,9980
1.00E+12,310,464,3.4,13800,464,1,13336,13800
1.00E+12,310,302,3.4,8990,302,1,8688,8990
2.10E+12,310,1688,8.1,20800,1688,1,19112,20800
1.00E+12,310,2598,10,25980,2598,1,23382,25980
1.00E+12,200,9610,16.3,59000,9610,1,49390,59000
1.00E+12,300,9610,16.3,59000,9610,1,49390,59000
8020697,310,428,10,4280,1712,4,15408,17120
1.00E+12,310,215,10,2150,1720,8,15480,17200
1.00E+12,300,7980,20.5,39000,7980,1,31020,39000
1.00E+12,200,9240,14.4,64000,9240,1,54760,64000
1.00E+12,601,347,5,6950,347,1,6603,6950
1.00E+12,200,16130,16.3,99000,16130,1,82870,99000
1.00E+12,500,13110,27.8,47200,13110,1,34090,47200
1.00E+12,300,12430,26,47790,37290,3,106080,143370
1.00E+12,500,12430,26,47790,37290,3,106080,143370
1.00E+12,310,480,10,4800,480,1,4320,4800
6622420,310,395,10,3950,3555,9,31995,35550
1.00E+12,310,238,10,2380,238,1,2142,2380
1.00E+12,340,138,7,1980,276,2,3684,3960
1.00E+12,200,28620,18,159000,28620,1,130380,159000
1.00E+12,310,598,10,5980,598,1,5382,5980
1.00E+12,310,1298,10,12980,1298,1,11682,12980
1.00E+12,501,352,8.8,3980,352,1,3628,3980
6617166,100,19,1,1980,19,1,1961,1980
2.10E+12,100,15,0.9,1580,15,1,1565,1580
2.10E+12,200,378,10.9,3480,378,1,3102,3480
1.00E+12,500,8424,17.6,48000,8424,1,39576,48000
1.00E+12,200,1754,10.9,16100,1754,1,14346,16100
1.00E+12,310,245,5,4900,980,4,18620,19600
1.00E+12,310,196,5,3920,196,1,3724,3920
1.00E+12,200,2214,6,36900,2214,1,34686,36900
6778,200,5447,21,26000,5447,1,20553,26000
1.00E+12,310,74,5,1480,74,1,1406,1480
2.10E+12,310,245,5,4900,735,3,13965,14700
1.00E+12,310,222,7,3180,444,2,5916,6360
1.00E+12,310,274,9.5,2880,274,1,2606,2880
1.00E+12,310,465,9.5,4880,465,1,4415,4880
7943526,310,427,9.5,4480,427,1,4053,4480
1.00E+12,310,1854,18.6,9980,1854,1,8126,9980
1.00E+12,310,93,9.5,980,1680,18,15960,17640
1.00E+12,205,3778,38.6,9780,3778,1,6002,9780
1.00E+12,310,474,17.1,2780,474,1,2306,2780
1.00E+12,310,210,7.8,2680,210,1,2470,2680
1.00E+12,200,8510,23,37000,8510,1,28490,37000
2.10E+12,310,1488,18.6,7980,1488,1,6492,7980
8069282,340,175,7,2500,350,2,4650,5000
1.00E+12,200,1043,7,14900,1043,1,13857,14900
2.10E+12,310,274,5,5480,548,2,10412,10960
8410642,310,99,5,1980,495,5,9405,9900
1.00E+12,310,698,10,6980,1396,2,12564,13960
1.00E+12,310,368,10,3680,2208,6,19872,22080
1.00E+12,300,3000,16.7,17980,15000,5,74900,89900
1.00E+12,300,3000,20,14980,33000,11,131780,164780
1.00E+12,310,313,7,4480,1565,5,20835,22400
6609408,310,185,4.6,3980,185,1,3795,3980
1.00E+12,310,129,4.6,2780,129,1,2651,2780
1.00E+12,310,69,4.7,1480,69,1,1411,1480
8039735,310,97,4.6,2100,97,1,2003,2100
2.10E+12,200,1620,20,8100,21060,13,84240,105300
1.00E+12,200,11530,19.2,59900,11530,1,48370,59900
8333642,310,75,10,750,150,2,1350,1500
1.00E+12,310,298,10,2980,298,1,2682,2980
1.00E+12,310,78,10,780,1404,18,12636,14040
1.00E+12,310,745,9.3,7980,745,1,7235,7980
1.00E+12,100,4531,16.3,27800,9062,2,46538,55600
8989814,310,434,9.3,4680,434,1,4246,4680
1.00E+12,200,33710,25,135100,67420,2,202780,270200
1.00E+12,310,287,14.5,1980,1722,6,10158,11880
7073945,240,1560,40,3900,24960,16,37440,62400
1.00E+12,310,418,7,5980,2926,7,38934,41860
7938700,511,7747,53.5,14480,61972,8,53868,115840
1.00E+12,310,390,9.8,3980,390,1,3590,3980
2.10E+12,200,4255,17.7,24000,4255,1,19745,24000
2.10E+12,205,1378,18.4,7480,1378,1,6102,7480
1.00E+12,200,42140,28,150500,42140,1,108360,150500
1.00E+12,310,449,5,8980,898,2,17062,17960
,,,,,,,,
1.00E+12,200,1990,10,19900,1990,1,17910,19900
6609384,310,298,10,2980,298,1,2682,2980
1.00E+12,310,1578,10,15780,1578,1,14202,15780
1.00E+12,310,188,10,1880,1128,6,10152,11280
1.00E+12,240,257,13,1980,257,1,1723,1980
6615204,310,603,9.3,6480,603,1,5877,6480
1.00E+12,100,103,2,5180,103,1,5077,5180
1.00E+12,310,269,7.3,3680,269,1,3411,3680
1.00E+12,100,696,11.8,5900,1392,2,10408,11800
,,,,,,,,
7151013,310,159,5,3180,318,2,6042,6360
6618823,310,104,5,2080,936,9,17784,18720
1.00E+12,310,249,5,4980,249,1,4731,4980
7175427,310,252,7,3600,252,1,3348,3600
2.10E+12,200,2176,12.2,17800,2176,1,15624,17800
1.00E+12,310,535,10.7,4980,1606,3,13334,14940
2.10E+12,100,3521,22.3,15800,3521,1,12279,15800
2.10E+12,100,751,10.8,6980,1501,2,12459,13960
2.10E+12,100,1392,10.8,12900,2783,2,23017,25800
2.10E+12,100,643,10.8,5980,1286,2,10674,11960
6616270,501,667,10.8,6200,667,1,5533,6200
1.00E+12,501,472,8.9,5280,472,1,4808,5280
1.00E+12,100,9545,31.4,30400,19090,2,41710,60800
2.10E+12,200,4393,33.8,12980,4393,1,8587,12980
1.00E+12,100,351,11.8,2980,351,1,2629,2980
1.00E+12,501,9545,31.4,30400,19090,2,41710,60800
2.10E+12,501,802,11.8,6800,802,1,5998,6800
1.00E+12,310,637,11.8,5400,637,1,4763,5400
7513645,601,579,16.2,3580,579,1,3001,3580
2.10E+12,310,271,7.2,3780,271,1,3509,3780
2.10E+12,310,1848,14.4,12800,1848,1,10952,12800
1.00E+12,310,3302,33.8,9780,3302,1,6478,9780
2.10E+12,310,1225,7.2,16980,2449,2,31511,33960
2.10E+12,310,214,7.2,2980,214,1,2766,2980
2.10E+12,310,502,7.2,6980,502,1,6478,6980
1.00E+12,340,852,9.9,8580,852,1,7728,8580
1.00E+12,310,1950,10,19500,5850,3,52650,58500
1.00E+12,310,348,7,4980,3828,11,50952,54780
9531275,310,348,7,4980,348,1,4632,4980
1.00E+12,310,208,7,2980,208,1,2772,2980
7332555,310,212,7,3040,636,3,8484,9120
9662183,100,148,5.9,2500,1480,10,23520,25000
1.00E+12,200,1900,19,10000,1900,1,8100,10000
1.00E+12,200,21440,16,134000,21440,1,112560,134000
1.00E+12,501,3256,17.1,19000,6512,2,31488,38000
1.00E+12,310,2598,26.2,9900,2598,1,7302,9900
1.00E+12,100,14128,18.7,75600,14128,1,61472,75600
1.00E+12,100,8894,18.7,47600,8894,1,38706,47600
1.00E+12,501,14128,18.7,75600,14128,1,61472,75600
1.00E+12,501,4960,26.2,18900,4960,1,13940,18900
1.00E+12,205,11252,37.6,29900,11252,1,18648,29900
2.10E+12,310,269,10.8,2480,269,1,2211,2480
1.00E+12,100,542,10.9,4980,542,1,4438,4980
1.00E+12,501,433,10.9,3980,433,1,3547,3980
1.00E+12,340,1293,7,18480,5172,4,68748,73920
1.00E+12,310,3117,14.5,21500,3117,1,18383,21500
,,,,,,,,
1.00E+12,200,3690,10,36900,3690,1,33210,36900
1.00E+12,200,9140,20,45740,9140,1,36600,45740
1.00E+12,500,6300,6,105000,6300,1,98700,105000
2.10E+12,310,388,10,3880,1164,3,10476,11640
1.00E+12,200,1800,10,18000,1800,1,16200,18000
1.00E+12,310,376,7,5380,752,2,10008,10760
1.00E+12,310,593,7,8480,1186,2,15774,16960
1.00E+12,310,498,10,4980,3984,8,35856,39840
8104634,310,198,10,1980,594,3,5346,5940
7695728,310,138,10,1380,138,1,1242,1380
2.10E+12,310,139,5,2790,139,1,2651,2790
2.10E+12,200,569,28.7,1980,569,1,1411,1980
2.10E+12,200,1272,15,8480,15264,12,86496,101760
1.00E+12,500,4420,7.4,60000,4420,1,55580,60000
7588534,601,50,5,1000,150,3,2850,3000
1.00E+12,310,801,9,8880,801,1,8079,8880
1.00E+12,200,1080,3,36000,1080,1,34920,36000
1.00E+12,310,651,6,10900,651,1,10249,10900
1.00E+12,310,1535,15.4,9980,1535,1,8445,9980
1.00E+12,310,451,6,7560,451,1,7109,7560
1.00E+12,310,96,6,1600,382,4,6018,6400
1.00E+12,310,1497,6,24900,1497,1,23403,24900
8410589,601,359,14.5,2480,359,1,2121,2480
9701616,310,644,8.1,7980,1288,2,14672,15960
1.00E+12,310,321,38.7,830,8676,27,13734,22410
6617166,310,159,8,1980,159,1,1821,1980
1.00E+12,200,8454,26.8,31500,8454,1,23046,31500
1.00E+12,200,1200,15,8000,1200,1,6800,8000
1.00E+12,310,169,5,3380,169,1,3211,3380
2.10E+12,310,57,5,1150,171,3,3279,3450
1.00E+12,310,180,5,3600,180,1,3420,3600
1.00E+12,200,18150,21.8,83300,18150,1,65150,83300
1.00E+12,310,168,10,1680,168,1,1512,1680
1.00E+12,340,1796,20,8980,7184,4,28736,35920
1.00E+12,310,1721,38.2,4500,1721,1,2779,4500
1.00E+12,310,119,5,2380,119,1,2261,2380
2.10E+12,310,1027,24,4280,1027,1,3253,4280
1.00E+12,310,1081,7,15450,2162,2,28738,30900
1.00E+12,205,9850,50,19700,19700,2,19700,39400
8624666,310,110,7,1580,220,2,2940,3160
1.00E+12,310,68,6.9,980,136,2,1824,1960
8309816,310,82,6.9,1180,82,1,1098,1180
1.00E+12,310,208,7,2980,208,1,2772,2980
8083530,310,523,7,7480,2092,4,27828,29920
2.10E+12,310,1760,16.3,10800,3520,2,18080,21600
1.00E+12,310,693,7,9900,693,1,9207,9900
1.00E+12,310,648,10,6480,2592,4,23328,25920
1.00E+12,310,468,10,4680,936,2,8424,9360
1.00E+12,310,398,10,3980,1194,3,10746,11940
2.10E+12,601,2259,41.2,5480,2259,1,3221,5480
1.00E+12,100,648,16.3,3980,648,1,3332,3980
1.00E+12,100,2428,16.3,14900,2428,1,12472,14900
1.00E+12,100,4065,11.6,34900,4065,1,30835,34900
1.00E+12,200,1180,5,23600,1180,1,22420,23600
1.00E+12,300,11736,16.3,72000,11736,1,60264,72000
1.00E+12,310,1700,10,17000,1700,1,15300,17000
1.00E+12,310,3465,14.5,23900,3465,1,20435,23900
1.00E+12,300,2000,15.4,12980,4000,2,21960,25960
2.10E+12,310,1077,8.3,12900,1077,1,11823,12900
8844842,310,427,9.2,4650,427,1,4223,4650
1.00E+12,601,1084,13.7,7900,1084,1,6816,7900
1.00E+12,340,6860,6.9,99000,6860,1,92140,99000
1.00E+12,300,7912,18.4,43000,7912,1,35088,43000
1.00E+12,200,5398,5.9,91198,5398,1,85800,91198
1.00E+12,200,9800,20,49000,9800,1,39200,49000
2.10E+12,310,190,5.2,3680,190,1,3490,3680
2.10E+12,310,153,5.1,2980,153,1,2827,2980
1.00E+12,310,81,5.1,1580,81,1,1499,1580
2.10E+12,310,334,5.2,6480,334,1,6146,6480
1.00E+12,310,71,5.1,1380,71,1,1309,1380
8333613,310,198,5.1,3850,198,1,3652,3850
2.10E+12,310,7819,19.2,40800,7819,1,32981,40800
2.10E+12,310,143,5.1,2780,143,1,2637,2780
6618823,310,107,5.1,2080,107,1,1973,2080
2.10E+12,310,1448,4.8,29900,1448,1,28452,29900
1.00E+12,310,143,4.8,2980,143,1,2837,2980
1.00E+12,310,95,4.8,1980,95,1,1885,1980
1.00E+12,310,85,4.8,1780,170,2,3390,3560
10717445,310,80,4.8,1680,80,1,1600,1680
1.00E+12,300,3000,17.7,16980,3000,1,13980,16980
2.10E+12,200,8275,20.9,39500,49650,6,187350,237000
1.00E+12,340,2980,10,29800,5960,2,53640,59600
1.00E+12,310,816,9.1,8980,816,1,8164,8980
2.10E+12,310,2379,27.3,8725,4758,2,12692,17450
1.00E+12,310,452,9.1,4980,452,1,4528,4980
1.00E+12,310,2277,18.3,12450,2277,1,10173,12450
1.00E+12,310,6384,18.3,34900,6384,1,28516,34900
1.00E+12,200,3384,12.6,26900,6768,2,47032,53800
1.00E+12,300,3384,12.6,26900,6768,2,47032,53800
1.00E+12,601,207,10.5,1980,207,1,1773,1980
2.10E+12,310,1690,11.4,14800,1690,1,13110,14800
8491731,310,360,10,3600,360,1,3240,3600
2.10E+12,310,3317,33.5,9900,3317,1,6583,9900
2.10E+12,310,995,7.7,13000,995,1,12005,13000
2.10E+12,310,2312,33.5,6900,2312,1,4588,6900
2.10E+12,200,1570,16.9,9300,1570,1,7730,9300
8018322,310,590,10,5900,1180,2,10620,11800
1.00E+12,310,416,8.7,4780,416,1,4364,4780
1.00E+12,310,365,10,3650,1095,3,9855,10950
315601,300,11890,14.5,82000,23780,2,140220,164000
1.00E+12,310,299,5,5980,299,1,5681,5980
2.10E+12,100,35,1,3580,35,1,3545,3580
6615474,100,25,1,2560,50,2,5070,5120
1.00E+12,501,0,0,7980,0,1,7980,7980
1.00E+12,501,0,0,3980,0,1,3980,3980
1.00E+12,310,100,10,1000,200,2,1800,2000
1.00E+12,100,159,5,3180,159,1,3021,3180
1.00E+12,200,1330,8.9,15000,2660,2,27340,30000
1.00E+12,501,0,0,19900,0,1,19900,19900
1.00E+12,200,350,5,7000,700,2,13300,14000
1.00E+12,310,348,10,3480,1044,3,9396,10440
1.00E+12,200,2475,9,27500,2475,1,25025,27500
2.10E+12,310,3322,37,8980,23254,7,39606,62860
2.10E+12,200,3322,37,8980,3322,1,5658,8980
1.00E+12,200,1131,14.5,7800,2262,2,13338,15600
1.00E+12,310,958,13.9,6900,958,1,5942,6900
7465142,310,1581,9.4,16900,1581,1,15319,16900
8527105,310,933,9.3,9980,933,1,9047,9980
1.00E+12,200,1556,4,38900,1556,1,37344,38900
6615606,310,275,10,2750,1650,6,14850,16500
1.00E+12,310,398,10,3980,796,2,7164,7960
9659361,310,820,10,8200,820,1,7380,8200
1.00E+12,310,298,10,2980,894,3,8046,8940
1.00E+12,300,3771,21,18000,3771,1,14229,18000
1.00E+12,310,426,9.9,4320,852,2,7788,8640
1.00E+12,310,12274,18.9,65000,12274,1,52726,65000
1.00E+12,100,298,10,2980,596,2,5364,5960
1.00E+12,310,1679,16.8,9980,1679,1,8301,9980
7408181,310,376,7.6,4980,376,1,4604,4980
2.10E+12,601,10249,25.1,40800,10249,1,30551,40800
7588534,100,116,11.6,1000,464,4,3536,4000
1.00E+12,100,893,16.3,5480,893,1,4587,5480
7021920,340,159,16.2,980,1749,11,9031,10780
1.00E+12,200,4427,11.7,38000,4427,1,33573,38000
1.00E+12,310,295,5,5900,295,1,5605,5900
8210501,310,845,5,16900,845,1,16055,16900
1.00E+12,240,1657,30.2,5480,8285,5,19115,27400
2.10E+12,200,1539,17.7,8700,1539,1,7161,8700
1.00E+12,511,4114,55,7480,32912,8,26928,59840
1.00E+12,310,588,10,5880,1764,3,15876,17640
1.00E+12,310,388,10,3880,388,1,3492,3880
1.00E+12,310,798,10,7980,1596,2,14364,15960
1.00E+12,310,388,10,3880,1552,4,13968,15520
1.00E+12,310,1698,10,16980,1698,1,15282,16980
1.00E+12,310,974,16.3,5980,974,1,5006,5980
8333613,100,627,16.3,3850,1881,3,9669,11550
1.00E+12,200,13110,22.2,59000,13110,1,45890,59000
1.00E+12,310,103,7,1480,412,4,5508,5920
1.00E+12,100,908,19,4780,908,1,3872,4780
2.10E+12,200,5615,40.4,13900,5615,1,8285,13900
9051273,100,475,14.5,3280,475,1,2805,3280
1.00E+12,310,6697,18.9,35400,6697,1,28703,35400
1.00E+12,240,2160,30,7200,2160,1,5040,7200
1.00E+12,205,1530,30,5100,29070,19,67830,96900
2.10E+12,310,1114,28,3980,6683,6,17197,23880
2.10E+12,310,168,10,1680,336,2,3024,3360
2.10E+12,310,418,7,5980,2508,6,33372,35880
6612114,310,1767,11.8,14980,1767,1,13213,14980
1.00E+12,501,354,11.8,3000,354,1,2646,3000
1.00E+12,310,298,10,2980,1788,6,16092,17880
1.00E+12,310,1161,9.8,11800,1161,1,10639,11800
1.00E+12,310,982,9.8,9980,982,1,8998,9980
1.00E+12,310,748,10,7480,1496,2,13464,14960
1.00E+12,310,390,10,3900,390,1,3510,3900
1.00E+12,310,1190,10,11900,1190,1,10710,11900
1.00E+12,310,598,10,5980,6578,11,59202,65780
2.10E+12,310,68,10,680,68,1,612,680
2.10E+12,200,1918,28,6850,1918,1,4932,6850
10228415,310,838,10,8380,1676,2,15084,16760
1.00E+12,310,118,10,1180,118,1,1062,1180
2.10E+12,310,198,10,1980,1980,10,17820,19800
1.00E+12,310,445,5,8900,445,1,8455,8900
2.10E+12,310,385,5,7700,1155,3,21945,23100
1.00E+12,310,595,5,11900,595,1,11305,11900
1.00E+12,310,229,7,3280,458,2,6102,6560
6615168,310,236,7,3380,944,4,12576,13520
1.00E+12,310,1090,10,10900,1090,1,9810,10900
1.00E+12,200,1788,17.9,9980,3576,2,16384,19960
1.00E+12,200,6600,15,44000,13200,2,74800,88000
2.10E+12,310,285,7,4080,285,1,3795,4080
8570314,310,439,7,6280,878,2,11682,12560
1.00E+12,200,4300,17.2,25000,4300,1,20700,25000
1.00E+12,300,219,1,21900,876,4,86724,87600
7594661,100,79,1,7980,79,1,7901,7980
1.00E+12,100,39,1,3980,39,1,3941,3980
1.00E+12,501,14,0.9,1480,14,1,1466,1480
79603,200,990,5,19800,1980,2,37620,39600
1.00E+12,310,9301,26.2,35500,18602,2,52398,71000
1.00E+12,500,12960,18,72000,12960,1,59040,72000
1.00E+12,310,300,11.6,2580,300,1,2280,2580
1.00E+12,310,1597,16.3,9800,1597,1,8203,9800
7896337,200,2112,24,8800,2112,1,6688,8800
1.00E+12,100,300,11.6,2580,300,1,2280,2580
1.00E+12,100,288,11.6,2480,288,1,2192,2480
1.00E+12,100,184,11.6,1580,184,1,1396,1580
1.00E+12,310,476,6.8,6980,476,1,6504,6980
1.00E+12,310,476,6.8,6980,476,1,6504,6980
1.00E+12,100,495,5,9900,495,1,9405,9900
1.00E+12,300,9181,18.4,49900,9181,1,40719,49900
1.00E+12,310,518,16.3,3180,1036,2,5324,6360
6611373,310,279,7,3990,558,2,7422,7980
1.00E+12,310,398,10,3980,1592,4,14328,15920
7452411,310,110,5,2200,110,1,2090,2200
1.00E+12,200,5593,29.4,19000,5593,1,13407,19000
1.00E+12,310,368,10,3680,368,1,3312,3680
1.00E+12,310,1280,10,12800,1280,1,11520,12800
1.00E+12,310,550,10,5500,550,1,4950,5500
1.00E+12,310,198,10,1980,1188,6,10692,11880
9595786,310,398,10,3980,796,2,7164,7960
2.10E+12,205,12494,34.9,35800,37482,3,69918,107400
2.10E+12,310,12494,34.9,35800,37482,3,69918,107400
2.10E+12,310,313,7,4480,313,1,4167,4480
2.10E+12,200,1272,40,3180,1272,1,1908,3180
1.00E+12,310,586,6.5,8980,586,1,8394,8980
1.00E+12,310,520,6.5,7980,520,1,7460,7980
1.00E+12,310,364,6.5,5580,364,1,5216,5580
1.00E+12,240,1377,20.5,6730,4131,3,16059,20190
8265786,310,120,6.7,1780,120,1,1660,1780
1.00E+12,310,333,6.7,4950,333,1,4617,4950
7022418,310,417,11.6,3580,417,1,3163,3580
2.10E+12,310,3160,26.4,11980,31600,10,88200,119800
8634542,310,548,10,5480,548,1,4932,5480
1.00E+12,310,438,10,4380,438,1,3942,4380
8333663,340,69,7,990,138,2,1842,1980
1.00E+12,310,158,10,1580,158,1,1422,1580
1.00E+12,310,298,10,2980,1192,4,10728,11920
8074443,310,372,8.6,4320,372,1,3948,4320
2.10E+12,200,4346,10.9,39800,4346,1,35454,39800
7291157,310,229,7,3280,2519,11,33561,36080
8566118,310,278,7,3980,556,2,7404,7960
8568431,240,284,6.6,4280,284,1,3996,4280
2.10E+12,310,990,9.2,10800,990,1,9810,10800
2.10E+12,310,1128,45.5,2480,2256,2,2704,4960
7883212,310,820,10,8200,3280,4,29520,32800
1.00E+12,200,27410,27.9,98100,27410,1,70690,98100
1.00E+12,310,218,10,2180,218,1,1962,2180
1.00E+12,300,2500,31.3,7980,7500,3,16440,23940
8641461,310,870,9.7,8980,1740,2,16220,17960
1.00E+12,200,1320,14.2,9300,1320,1,7980,9300
7104921,310,391,7,5590,391,1,5199,5590
1.00E+12,310,346,7,4950,346,1,4604,4950
1.00E+12,310,346,7,4950,346,1,4604,4950
1.00E+12,205,7820,31.5,24800,31280,4,67920,99200
2.10E+12,310,27,4.9,550,2430,90,47070,49500
1.00E+12,200,2900,10,29000,2900,1,26100,29000
1.00E+12,310,125,7.9,1580,125,1,1455,1580
1.00E+12,500,6382,20.7,30900,6382,1,24518,30900
1.00E+12,100,358,9.7,3680,358,1,3322,3680
1.00E+12,100,388,9.7,3980,388,1,3592,3980
1.00E+12,205,3380,20,16900,6760,2,27040,33800
1.00E+12,310,199,5,3980,398,2,7562,7960
1.00E+12,310,199,5,3980,199,1,3781,3980
8537421,310,296,10,2960,1776,6,15984,17760
1.00E+12,500,19691,22.1,89100,19691,1,69409,89100
1.00E+12,310,1684,15.6,10780,6736,4,36384,43120
1.00E+12,240,800,5,16000,13600,17,258400,272000
1.00E+12,500,800,5,16000,16000,20,304000,320000
6615109,310,208,7,2980,208,1,2772,2980
2.10E+12,310,1598,10,15980,4794,3,43146,47940
1.00E+12,310,349,5,6980,349,1,6631,6980
1.00E+12,310,199,5,3980,199,1,3781,3980
1.00E+12,310,298,10,2980,1490,5,13410,14900
1.00E+12,100,270,10,2700,270,1,2430,2700
1.00E+12,310,1008,7.5,13410,1008,1,12402,13410
1.00E+12,200,6894,26,26500,6894,1,19606,26500
1.00E+12,310,320,10,3200,640,2,5760,6400
9598208,310,670,10,6700,670,1,6030,6700
1.00E+12,310,343,7,4900,343,1,4557,4900
1.00E+12,310,140,10,1400,700,5,6300,7000
1.00E+12,310,898,10,8980,898,1,8082,8980
1.00E+12,310,348,10,3480,696,2,6264,6960
1.00E+12,601,99,9.7,1020,99,1,921,1020
1.00E+12,200,2780,10,27800,2780,1,25020,27800
1.00E+12,310,273,7,3900,273,1,3627,3900
6616801,310,149,5,2980,298,2,5662,5960
1.00E+12,310,72,5,1450,1008,14,19292,20300
1.00E+12,200,430,3.3,13000,860,2,25140,26000
1.00E+12,310,1118,7,15980,4472,4,59448,63920
1.00E+12,310,159,7,2280,159,1,2121,2280
1.00E+12,310,350,10,3500,2450,7,22050,24500
1.00E+12,200,170,10,1700,1020,6,9180,10200
1.00E+12,310,248,10,2480,1240,5,11160,12400
1.00E+12,200,9710,24.9,39000,9710,1,29290,39000
1.00E+12,300,9710,24.9,39000,9710,1,29290,39000
1.00E+12,200,7720,14.3,54000,7720,1,46280,54000
2.10E+12,310,269,10.8,2480,538,2,4422,4960
1.00E+12,310,596,10.9,5480,596,1,4884,5480
1.00E+12,310,141,10.8,1300,282,2,2318,2600
2.10E+12,100,269,10.8,2480,538,2,4422,4960
1.00E+12,100,1705,40.6,4200,1705,1,2495,4200
1.00E+12,100,1705,40.6,4200,1705,1,2495,4200
1.00E+12,100,363,10.9,3340,363,1,2977,3340
1.00E+12,100,1329,10.9,12200,1329,1,10871,12200
2.10E+12,100,182,10.8,1680,182,1,1498,1680
2.10E+12,100,247,10.8,2280,247,1,2033,2280
1.00E+12,501,1705,40.6,4200,1705,1,2495,4200
7372848,501,411,10.9,3780,411,1,3369,3780
1.00E+12,501,272,10.9,2500,272,1,2228,2500
2.10E+12,501,320,10,3200,320,1,2880,3200
1.00E+12,310,219,7.9,2780,219,1,2561,2780
1.00E+12,100,180,7.9,2280,180,1,2100,2280
1.00E+12,100,219,7.9,2780,219,1,2561,2780
7586016,501,1141,7.9,14400,2282,2,26518,28800
2.10E+12,501,299,7.9,3780,299,1,3481,3780
1.00E+12,310,495,10,4950,495,1,4455,4950
8226646,310,378,10,3780,1134,3,10206,11340
6609348,310,287,14.5,1980,287,1,1693,1980
6610205,100,181,14.5,1250,181,1,1069,1250
1.00E+12,100,229,14.5,1580,229,1,1351,1580
1.00E+12,100,3697,14.5,25500,3697,1,21803,25500
6609348,340,138,7,1980,138,1,1842,1980
8968177,310,1057,7.6,13980,1057,1,12923,13980
9071499,310,1118,7.6,14780,1118,1,13662,14780
1.00E+12,200,4455,36.2,12300,4455,1,7845,12300
1.00E+12,340,145,7,2080,290,2,3870,4160
2.10E+12,240,1074,30,3580,6444,6,15036,21480
1.00E+12,200,9900,5,198000,9900,1,188100,198000
1.00E+12,240,1800,40,4500,5400,3,8100,13500
1.00E+12,310,298,10,2980,1490,5,13410,14900
1.00E+12,310,244,5,4880,2440,10,46360,48800
7896436,310,174,5,3480,174,1,3306,3480
2.10E+12,100,956,8.9,10800,956,1,9844,10800
2.10E+12,100,2164,36.2,5980,4328,2,7632,11960
8076920,310,560,8.1,6900,560,1,6340,6900
1.00E+12,310,217,8.1,2680,217,1,2463,2680
1.00E+12,310,567,8.1,6980,567,1,6413,6980
1.00E+12,310,498,10,4980,996,2,8964,9960
1.00E+12,200,2320,14.5,16000,2320,1,13680,16000
1.00E+12,100,1932,46,4200,11592,6,13608,25200
1.00E+12,310,6145,12.3,49900,6145,1,43755,49900
1.00E+12,200,2573,12.3,20900,2573,1,18327,20900
1.00E+12,310,923,20.6,4480,1846,2,7114,8960
1.00E+12,310,1640,11.8,13900,1640,1,12260,13900
10008699,100,469,11.8,3980,469,1,3511,3980
1.00E+12,100,410,11.8,3480,410,1,3070,3480
9707916,501,327,11.8,2780,327,1,2453,2780
1.00E+12,501,923,20.6,4480,1846,2,7114,8960
1.00E+12,501,823,11.8,6980,823,1,6157,6980
1.00E+12,501,1640,11.8,13900,1640,1,12260,13900
1.00E+12,310,198,10,1980,198,1,1782,1980
1.00E+12,310,1012,14.5,6980,3036,3,17904,20940
7050044,310,295,9.9,2980,295,1,2685,2980
1.00E+12,310,593,9.9,5980,593,1,5387,5980
8224028,310,1290,10,12900,1290,1,11610,12900
1.00E+12,511,3740,50,7480,63580,17,63580,127160
2.10E+12,310,5662,19,29800,5662,1,24138,29800
7707170,240,558,10,5580,1674,3,15066,16740
1.00E+12,310,120,10,1200,600,5,5400,6000
1.00E+12,310,848,10,8480,1696,2,15264,16960
1.00E+12,310,660,9.6,6880,660,1,6220,6880
1.00E+12,310,314,9.6,3280,314,1,2966,3280
1.00E+12,200,3190,14.5,22000,3190,1,18810,22000
7354917,310,110,7,1580,330,3,4410,4740
2.10E+12,310,629,9,6980,629,1,6351,6980
6825280,310,491,9,5450,491,1,4959,5450
1.00E+12,310,223,9,2480,223,1,2257,2480
1.00E+12,200,22700,50,45400,22700,1,22700,45400
2.10E+12,310,115,9.7,1180,115,1,1065,1180
2.10E+12,310,1721,9.6,18000,1721,1,16279,18000
1.00E+12,240,287,14.5,1980,1435,5,8465,9900
1.00E+12,310,13475,19.3,70000,13475,1,56525,70000
1.00E+12,310,8260,28,29500,8260,1,21240,29500
2.10E+12,310,180,10,1800,720,4,6480,7200
6618424,310,55,5,1100,55,1,1045,1100
1.00E+12,200,3960,20,19800,3960,1,15840,19800
1.00E+12,200,782,7.8,9970,782,1,9188,9970
1.00E+12,200,11811,15.4,76900,82677,7,455623,538300
1.00E+12,310,1218,9.5,12800,1218,1,11582,12800
1.00E+12,205,1870,36.7,5100,3739,2,6461,10200
1.00E+12,310,257,7,3680,257,1,3423,3680
1.00E+12,310,278,7,3980,556,2,7404,7960
1.00E+12,310,161,7,2300,161,1,2139,2300
6609427,310,171,7,2450,855,5,11395,12250
2.10E+12,310,340,10,3400,680,2,6120,6800
8208497,310,748,10,7480,1496,2,13464,14960
2.10E+12,601,519,14.5,3580,1038,2,6122,7160
2.10E+12,310,124,7.4,1680,247,2,3113,3360
2.10E+12,310,138,7.3,1880,138,1,1742,1880
1.00E+12,310,253,7.4,3430,506,2,6354,6860
1.00E+12,501,18137,20.8,87200,18137,1,69063,87200
1.00E+12,200,5232,8,65400,5232,1,60168,65400
1.00E+12,310,498,10,4980,1992,4,17928,19920
1.00E+12,310,398,10,3980,1194,3,10746,11940
8237531,310,283,7.9,3600,283,1,3317,3600
1.00E+12,200,916,13.3,6900,916,1,5984,6900
2.10E+12,601,128,16,800,128,1,672,800
2.10E+12,310,181,11.7,1550,181,1,1369,1550
7628565,310,453,11.7,3880,453,1,3427,3880
2.10E+12,205,1608,29.3,5480,1608,1,3872,5480
1.00E+12,500,1900,5,38000,1900,1,36100,38000
1.00E+12,200,990,10,9900,990,1,8910,9900
1.00E+12,310,8540,28,30500,34160,4,87840,122000
1.00E+12,240,1296,20,6480,9072,7,36288,45360
1.00E+12,200,19270,23.5,82000,38540,2,125460,164000
1.00E+12,200,2953,9.9,29800,2953,1,26847,29800
1.00E+12,240,110,10,1100,220,2,1980,2200
1.00E+12,310,3514,9.2,38400,3514,1,34886,38400
1.00E+12,310,180,9.1,1980,1260,7,12600,13860
1.00E+12,310,273,18.2,1500,273,1,1227,1500
1.00E+12,100,1911,13.7,13980,1911,1,12069,13980
6616423,300,5200,25,20800,5200,1,15600,20800
1.00E+12,310,429,5,8580,3432,8,65208,68640
1.00E+12,310,937,9.4,9980,937,1,9043,9980
1.00E+12,340,433,6.2,6980,433,1,6547,6980
1.00E+12,340,240,6.2,3880,240,1,3640,3880
7335759,340,234,6.2,3780,234,1,3546,3780
1.00E+12,340,91,6.1,1480,91,1,1389,1480
1.00E+12,340,2205,7,31500,4410,2,58590,63000
1.00E+12,310,493,9.9,4990,986,2,8994,9980
2.10E+12,340,450,10,4500,8100,18,72900,81000
1.00E+12,240,1000,9.3,10780,4000,4,39120,43120
1.00E+12,500,16380,12.7,129000,16380,1,112620,129000
2.10E+12,200,9047,22.9,39500,27140,3,91360,118500
2.10E+12,310,632,18.2,3480,632,1,2848,3480
1.00E+12,310,231,9.1,2550,231,1,2319,2550
2.10E+12,200,2100,16.2,13000,18900,9,98100,117000
1.00E+12,310,628,7,8980,628,1,8352,8980
8259031,310,222,7,3180,666,3,8874,9540
1.00E+12,500,6850,18.5,37000,6850,1,30150,37000
1.00E+12,310,504,14.5,3480,504,1,2976,3480
1.00E+12,100,504,14.5,3480,504,1,2976,3480
1.00E+12,200,22250,25,89000,22250,1,66750,89000
1.00E+12,200,10350,15,69000,10350,1,58650,69000
7694606,310,290,10,2900,580,2,5220,5800
1.00E+12,601,50,5,1000,50,1,950,1000
1.00E+12,100,99,5,1990,594,6,11346,11940
1.00E+12,200,5850,15,39000,11700,2,66300,78000
8606784,310,99,5,1980,594,6,11286,11880
2.10E+12,310,1616,16.5,9800,1616,1,8184,9800
1.00E+12,310,698,7,9980,3490,5,46410,49900
1.00E+12,310,187,7,2680,748,4,9972,10720
1.00E+12,310,350,8.2,4280,350,1,3930,4280
1.00E+12,310,883,8.2,10800,883,1,9917,10800
1.00E+12,310,98,8.2,1200,98,1,1102,1200
7350960,511,1580,40,3950,9480,6,14220,23700
1.00E+12,310,408,10,4080,408,1,3672,4080
8634213,310,530,7,7580,530,1,7050,7580
2.10E+12,310,530,10,5300,530,1,4770,5300
1.00E+12,310,478,10,4780,956,2,8604,9560
1.00E+12,200,1250,5,25000,1250,1,23750,25000
1.00E+12,601,119,5,2380,119,1,2261,2380
1.00E+12,310,698,7,9980,698,1,9282,9980
1.00E+12,310,699,9.5,7380,699,1,6681,7380
1.00E+12,310,614,9.5,6480,614,1,5866,6480
2.10E+12,310,159,9.5,1680,318,2,3042,3360
8218669,310,1130,9.4,11980,1130,1,10850,11980
1.00E+12,310,928,9.4,9900,928,1,8972,9900
2.10E+12,205,2553,32.3,7900,7659,3,16041,23700
1.00E+12,310,817,23.5,3480,1634,2,5326,6960
1.00E+12,310,898,10,8980,2694,3,24246,26940
1.00E+12,310,817,23.5,3480,1634,2,5326,6960
6616190,310,350,8.8,3980,350,1,3630,3980
1.00E+12,310,605,8.8,6880,605,1,6275,6880
1.00E+12,500,56461,7.8,721000,56461,1,664539,721000
2.10E+12,310,989,21.5,4590,989,1,3601,4590
1.00E+12,310,629,9,6980,629,1,6351,6980
1.00E+12,310,358,9,3980,358,1,3622,3980
1.00E+12,100,247,5,4950,494,2,9406,9900
1.00E+12,200,37800,13.6,278000,37800,1,240200,278000
1.00E+12,205,10000,50.3,19900,10000,1,9900,19900
1.00E+12,200,2635,31,8500,15810,6,35190,51000
1.00E+12,310,199,5,3980,597,3,11343,11940
1.00E+12,601,374,5,7480,374,1,7106,7480
7581409,100,21,1.9,1080,21,1,1059,1080
7889192,100,22,2,1100,22,1,1078,1100
1.00E+12,310,2163,7,30900,2163,1,28737,30900
8606784,310,138,7,1980,138,1,1842,1980
9053152,310,1732,9.9,17580,1732,1,15848,17580
1.00E+12,310,10768,27.6,39000,10768,1,28232,39000
1.00E+12,200,3138,32,9800,12552,4,26648,39200
1.00E+12,240,851,19,4480,3404,4,14516,17920
1.00E+12,310,138,7,1980,552,4,7368,7920
1.00E+12,601,202,5,4050,202,1,3848,4050
2.10E+12,310,1198,10,11980,5990,5,53910,59900
2.10E+12,200,355,20.3,1750,2485,7,9765,12250
2.10E+12,310,5211,40.1,12980,5211,1,7769,12980
2.10E+12,200,8875,44.4,19980,8875,1,11105,19980
1.00E+12,310,832,19,4380,832,1,3548,4380
6610187,310,73,10,730,511,7,4599,5110
1.00E+12,240,832,19,4380,832,1,3548,4380
1.00E+12,200,2800,10,28000,2800,1,25200,28000
2.10E+12,100,2265,16.3,13900,4530,2,23270,27800
2.10E+12,100,293,16.3,1800,586,2,3014,3600
2.10E+12,340,733,16.3,4500,1466,2,7534,9000
2.10E+12,200,1351,25.6,5280,18914,14,55006,73920
2.10E+12,310,2092,17.7,11800,2092,1,9708,11800
2.10E+12,310,1313,13.2,9980,1313,1,8667,9980
9653151,100,351,17.7,1980,351,1,1629,1980
1.00E+12,310,2080,5,41600,2080,1,39520,41600
1.00E+12,310,658,10,6580,1974,3,17766,19740
2.10E+12,310,890,28,3180,1780,2,4580,6360
2.10E+12,100,199,5,3980,398,2,7562,7960
1.00E+12,310,584,8.5,6880,584,1,6296,6880
1.00E+12,500,1290,10,12900,1290,1,11610,12900
1.00E+12,200,3290,10,32900,3290,1,29610,32900
1.00E+12,200,3180,6,53000,3180,1,49820,53000
1.00E+12,310,37900,27.2,139500,37900,1,101600,139500
1.00E+12,310,159,7,2280,3816,24,50904,54720
2.10E+12,310,3836,7,54800,3836,1,50964,54800
1.00E+12,500,14702,25.8,57000,14702,1,42298,57000
1.00E+12,310,180,7,2580,180,1,2400,2580
1.00E+12,310,61472,9.8,629440,61472,1,567968,629440
1.00E+12,310,171,5.7,2980,171,1,2809,2980
1.00E+12,310,148,5.7,2580,148,1,2432,2580
1.00E+12,340,832,9.7,8580,832,1,7748,8580
1.00E+12,310,19878,35.2,56500,19878,1,36622,56500
1.00E+12,310,469,12,3900,1407,3,10293,11700
1.00E+12,200,1898,12,15780,1898,1,13882,15780
1.00E+12,240,1810,20.2,8980,3620,2,14340,17960
8328977,310,110,11.2,980,110,1,870,980
2.10E+12,310,402,11.2,3580,402,1,3178,3580
1.00E+12,310,159,7,2280,477,3,6363,6840
1.00E+12,310,1184,9.1,12980,1184,1,11796,12980
1.00E+12,310,454,9.1,4980,454,1,4526,4980
2.10E+12,200,1100,10,11000,2200,2,19800,22000
1.00E+12,310,2959,9,32980,5917,2,60043,65960
1.00E+12,310,398,10,3980,398,1,3582,3980
1.00E+12,310,257,7,3680,257,1,3423,3680
1.00E+12,310,906,5.7,15800,906,1,14894,15800
7668706,310,568,5.7,9900,568,1,9332,9900
1.00E+12,200,1790,10,17900,1790,1,16110,17900
1.00E+12,310,624,5,12480,624,1,11856,12480
1.00E+12,200,26820,20,134100,26820,1,107280,134100
1.00E+12,310,990,10,9900,3960,4,35640,39600
1.00E+12,200,6280,19.6,32000,6280,1,25720,32000
1.00E+12,310,192,9.7,1980,192,1,1788,1980
1.00E+12,310,1361,9.7,13980,1361,1,12619,13980
1.00E+12,310,1467,9.8,14980,1467,1,13513,14980
1.00E+12,200,10580,22.2,47700,10580,1,37120,47700
1.00E+12,310,1322,9.7,13580,1322,1,12258,13580
9656160,310,280,9.7,2880,280,1,2600,2880
1.00E+12,310,523,9.7,5380,523,1,4857,5380
1.00E+12,200,2500,10,25000,2500,1,22500,25000
1.00E+12,310,898,10,8980,898,1,8082,8980
7688082,310,498,10,4980,498,1,4482,4980
2.10E+12,310,106,7.1,1500,5303,50,69697,75000
2.10E+12,310,563,7.1,7980,563,1,7417,7980
1.00E+12,310,89,5,1780,1068,12,20292,21360
1.00E+12,200,3830,6,63900,3830,1,60070,63900
1.00E+12,500,3760,15.3,24500,3760,1,20740,24500
10622323,310,138,7,1980,138,1,1842,1980
1.00E+12,310,98,10,980,1078,11,9702,10780
1.00E+12,310,598,10,5980,2392,4,21528,23920
1.00E+12,240,1260,30,4200,1260,1,2940,4200
1.00E+12,310,801,8.2,9780,801,1,8979,9780
6942752,310,368,8.2,4500,368,1,4132,4500
1.00E+12,310,399,8.2,4880,399,1,4481,4880
8107421,310,1171,8.2,14300,1171,1,13129,14300
2.10E+12,340,299,7,4280,299,1,3981,4280
1.00E+12,310,488,7,6980,1464,3,19476,20940
6615615,310,196,7,2800,1176,6,15624,16800
1.00E+12,310,335,5.6,5980,335,1,5645,5980
8328977,310,55,5.6,980,110,2,1850,1960
1.00E+12,310,5756,52.8,10900,11512,2,10288,21800
1.00E+12,200,4865,9.7,49900,9730,2,90070,99800
1.00E+12,310,453,7,6480,453,1,6027,6480
1.00E+12,310,688,10,6880,2064,3,18576,20640
7150833,100,49,1,4990,49,1,4941,4990
8298695,100,8,0.9,880,8,1,872,880
7150833,501,49,1,4990,49,1,4941,4990
8077493,501,21,1,2150,42,2,4258,4300
1.00E+12,501,79,1,7980,79,1,7901,7980
1.00E+12,501,9,0.9,990,27,3,2943,2970
1.00E+12,501,19,1,1980,19,1,1961,1980
1.00E+12,200,70750,17.5,405000,70750,1,334250,405000
2.10E+12,310,880,10,8800,880,1,7920,8800
1.00E+12,100,22977,25,91800,22977,1,68823,91800
1.00E+12,340,1796,20,8980,1796,1,7184,8980
1.00E+12,100,2102,16.3,12900,2102,1,10798,12900
1.00E+12,340,1124,16.3,6900,1124,1,5776,6900
2.10E+12,310,144,8.6,1680,144,1,1536,1680
1.00E+12,310,1590,10,15900,1590,1,14310,15900
1.00E+12,310,2690,19,14160,2690,1,11470,14160
7909931,100,480,19,2530,480,1,2050,2530
1.00E+12,100,188,19,990,188,1,802,990
1.00E+12,100,188,19,990,188,1,802,990
1.00E+12,310,273,7,3900,546,2,7254,7800
1.00E+12,310,534,8.9,5980,534,1,5446,5980
2.10E+12,310,4296,36.3,11850,4296,1,7554,11850
1.00E+12,310,88,8.9,980,175,2,1785,1960
2.10E+12,310,266,8.9,2980,266,1,2714,2980
2.10E+12,200,2069,16.2,12800,2069,1,10731,12800
8967181,310,898,10,8980,898,1,8082,8980
1.00E+12,310,3325,17.5,19000,6650,2,31350,38000
1.00E+12,310,3061,7.8,39000,3061,1,35939,39000
1897420,310,3563,7,50900,3563,1,47337,50900
1.00E+12,310,399,5,7980,798,2,15162,15960
1.00E+12,310,114,5,2280,228,2,4332,4560
2.10E+12,310,1290,10,12900,1290,1,11610,12900
1.00E+12,310,12264,25,49000,12264,1,36736,49000
1.00E+12,310,138,10,1380,138,1,1242,1380
1.00E+12,310,325,5,6500,1300,4,24700,26000
8302192,310,325,6.5,4980,325,1,4655,4980
1.00E+12,310,65,6.5,1000,65,1,935,1000
1.00E+12,310,323,6.5,4950,323,1,4627,4950
1.00E+12,310,63,6.4,980,63,1,917,980
1.00E+12,310,194,6.5,2980,388,2,5572,5960
1.00E+12,310,181,6.5,2780,181,1,2599,2780
1.00E+12,310,227,6.5,3480,227,1,3253,3480
7095585,310,485,9.7,4980,1455,3,13485,14940
1.00E+12,310,374,5,7480,374,1,7106,7480
1.00E+12,310,1249,5,24980,1249,1,23731,24980
1.00E+12,200,4212,17.6,24000,4212,1,19788,24000
1.00E+12,310,176,5.1,3480,528,3,9912,10440
1.00E+12,310,506,5.1,9980,1518,3,28422,29940
1.00E+12,310,354,5.1,6980,1062,3,19878,20940
1.00E+12,310,431,5.1,8480,2583,6,48297,50880
1.00E+12,310,1349,5,26980,2698,2,51262,53960
9700874,310,32,3.2,990,32,1,958,990
1.00E+12,310,426,3.3,12900,426,1,12474,12900
1.00E+12,310,526,3.3,15900,526,1,15374,15900
1.00E+12,310,261,3.3,7900,261,1,7639,7900
1.00E+12,300,3000,18.8,15980,45000,15,194700,239700
1.00E+12,240,1473,30.7,4800,1473,1,3327,4800
7095585,310,542,10.9,4980,542,1,4438,4980
1.00E+12,310,109,10.9,1000,109,1,891,1000
1.00E+12,310,247,10.8,2280,247,1,2033,2280
7051239,100,211,10.9,1940,211,1,1729,1940
7095585,100,542,10.9,4980,542,1,4438,4980
7947578,501,109,10.9,1000,218,2,1782,2000
1.00E+12,501,1197,30.7,3900,1197,1,2703,3900
1.00E+12,200,600,5,12000,600,1,11400,12000
1.00E+12,200,4826,10,48260,4826,1,43434,48260
6614781,310,243,7,3480,486,2,6474,6960
2.10E+12,200,5025,39.3,12800,5025,1,7775,12800
1.00E+12,200,6879,17.5,39200,6879,1,32321,39200
1.00E+12,340,287,7,4100,287,1,3813,4100
1.00E+12,310,115,5,2300,115,1,2185,2300
1.00E+12,310,399,5,7990,798,2,15182,15980
6616347,310,349,5,6980,349,1,6631,6980
1.00E+12,310,134,5,2680,670,5,12730,13400
7632909,240,360,10,3600,720,2,6480,7200
1.00E+12,200,3100,10,31000,3100,1,27900,31000
1.00E+12,200,890,6.9,12900,890,1,12010,12900
1.00E+12,100,59,2,2980,59,1,2921,2980
7275213,501,469,11.8,3980,3283,7,24577,27860
1.00E+12,310,163,5.9,2780,163,1,2617,2780
1.00E+12,200,3487,15.9,22000,6974,2,37026,44000
1.00E+12,200,5563,15.8,35100,5563,1,29537,35100
1.00E+12,310,250,7,3580,250,1,3330,3580
1.00E+12,310,98,10,980,1470,15,13230,14700
1.00E+12,310,4180,20,20900,4180,1,16720,20900
1.00E+12,310,178,10,1780,356,2,3204,3560
2.10E+12,310,1080,10,10800,2160,2,19440,21600
2.10E+12,200,2189,55,3980,13134,6,10746,23880
10532571,310,558,7,7980,1116,2,14844,15960
1.00E+12,310,298,10,2980,1788,6,16092,17880
1.00E+12,310,199,5,3980,597,3,11343,11940
1.00E+12,310,105,7,1500,105,1,1395,1500
1.00E+12,310,4141,18.8,22000,12423,3,53577,66000
1.00E+12,100,1176,9.8,12000,2352,2,21648,24000
1.00E+12,100,1684,17,9900,1684,1,8216,9900
1.00E+12,300,742,10,7420,742,1,6678,7420
1.00E+12,200,3625,14.5,25000,7250,2,42750,50000
1.00E+12,501,84,5,1680,84,1,1596,1680
1.00E+12,200,510,4.9,10320,510,1,9810,10320
1.00E+12,200,9576,24,39900,9576,1,30324,39900
1.00E+12,310,78,8,980,78,1,902,980
1.00E+12,310,1106,8,13800,1106,1,12694,13800
1.00E+12,310,797,8,9980,797,1,9183,9980
1.00E+12,310,1393,7,19900,1393,1,18507,19900
1.00E+12,200,2220,8.9,25000,2220,1,22780,25000
1.00E+12,310,3950,5,79000,3950,1,75050,79000
1.00E+12,310,2232,37.8,5900,2232,1,3668,5900
1.00E+12,310,1740,37.8,4600,1740,1,2860,4600
1.00E+12,310,5978,37.8,15800,5978,1,9822,15800
1.00E+12,310,3216,37.8,8500,3216,1,5284,8500
1.00E+12,310,23544,24,98100,23544,1,74556,98100
9014178,501,457,10.9,4200,457,1,3743,4200
1.00E+12,310,858,10,8580,1716,2,15444,17160
1.00E+12,310,318,10,3180,318,1,2862,3180
1.00E+12,310,140,7.9,1780,140,1,1640,1780
6968406,310,138,7,1980,138,1,1842,1980
1.00E+12,310,124,7,1780,124,1,1656,1780
7275088,310,360,10,3600,1080,3,9720,10800
2.10E+12,310,424,5,8480,848,2,16112,16960
1.00E+12,310,898,10,8980,898,1,8082,8980
2.10E+12,200,680,10,6800,2040,3,18360,20400
7469562,310,558,7,7980,5022,9,66798,71820
1.00E+12,310,553,8,6950,1658,3,19192,20850
1.00E+12,310,205,7.9,2580,205,1,2375,2580
1.00E+12,310,364,7,5200,364,1,4836,5200
1.00E+12,310,867,4.3,19980,867,1,19113,19980
1.00E+12,310,278,7,3980,1946,7,25914,27860
9595276,310,194,5,3880,388,2,7372,7760
2.10E+12,310,308,10,3080,3080,10,27720,30800
1.00E+12,200,7800,10,78000,23400,3,210600,234000
1.00E+12,310,523,7,7480,523,1,6957,7480
1.00E+12,310,3990,10,39900,3990,1,35910,39900
10529800,310,218,10,2180,1090,5,9810,10900
1.00E+12,310,198,10,1980,792,4,7128,7920
9656160,310,257,8.9,2880,257,1,2623,2880
2.10E+12,310,539,7,7700,539,1,7161,7700
2.10E+12,310,539,7,7700,1617,3,21483,23100
6611508,310,1945,5,38900,3890,2,73910,77800
1.00E+12,200,560,4,14000,560,1,13440,14000
1.00E+12,200,9126,17.6,52000,9126,1,42874,52000
7335759,240,1512,40,3780,6048,4,9072,15120
1.00E+12,100,1298,10,12980,1298,1,11682,12980
1.00E+12,100,338,10,3380,338,1,3042,3380
1.00E+12,340,1244,14.5,8580,2488,2,14672,17160
1.00E+12,500,1331,8,16640,2662,2,30618,33280
1.00E+12,340,5384,7.9,67900,5384,1,62516,67900
1.00E+12,310,882,9.8,8980,882,1,8098,8980
1.00E+12,310,685,9.8,6980,685,1,6295,6980
8333662,310,580,18.8,3080,580,1,2500,3080
1.00E+12,200,2830,19,14900,2830,1,12070,14900
1.00E+12,300,26600,20.9,127000,26600,1,100400,127000
1.00E+12,300,5810,24.2,24000,5810,1,18190,24000
1.00E+12,310,1106,9.4,11800,1106,1,10694,11800
1.00E+12,310,94,9.4,1000,375,4,3625,4000
2.10E+12,310,4751,36.6,12980,9501,2,16459,25960
2.10E+12,310,1335,17.8,7480,1335,1,6145,7480
2.10E+12,205,1335,17.8,7480,1335,1,6145,7480
1.00E+12,310,574,5,11480,574,1,10906,11480
1.00E+12,310,143,6,2390,143,1,2247,2390
10226790,310,94,5.9,1580,94,1,1486,1580
1.00E+12,310,4436,24.8,17900,4436,1,13464,17900
2.10E+12,310,467,9.4,4980,467,1,4513,4980
8070178,310,197,9.4,2100,197,1,1903,2100
2.10E+12,310,1507,27.5,5480,1507,1,3973,5480
1.00E+12,310,648,10,6480,648,1,5832,6480
1.00E+12,310,628,10,6280,1256,2,11304,12560
1.00E+12,310,368,10,3680,736,2,6624,7360
6618348,100,294,5.9,4950,294,1,4656,4950
1.00E+12,501,672,5.9,11300,672,1,10628,11300
7095585,501,295,5.9,4980,295,1,4685,4980
1.00E+12,310,144,8.6,1680,288,2,3072,3360
1.00E+12,310,378,10.9,3480,378,1,3102,3480
1.00E+12,310,95,10.8,880,380,4,3140,3520
1.00E+12,310,215,10.9,1980,215,1,1765,1980
7709932,100,247,10.8,2280,247,1,2033,2280
1.00E+12,100,596,10.9,5480,596,1,4884,5480
9057122,501,1122,10.9,10300,1122,1,9178,10300
1.00E+12,501,378,10.9,3480,378,1,3102,3480
6994628,501,127,10.8,1180,127,1,1053,1180
1.00E+12,501,760,10.9,6980,760,1,6220,6980
1.00E+12,501,95,10.8,880,380,4,3140,3520
8634515,100,159,5,3180,318,2,6042,6360
1.00E+12,100,844,5,16880,844,1,16036,16880
1.00E+12,310,436,16.3,2680,872,2,4488,5360
2.10E+12,310,16149,41.4,39000,32298,2,45702,78000
1.00E+12,100,1939,16.3,11900,1939,1,9961,11900
1.00E+12,310,190,5,3800,570,3,10830,11400
1.00E+12,310,424,5,8480,848,2,16112,16960
1.00E+12,200,20155,14.5,139000,20155,1,118845,139000
8233374,310,174,5,3480,522,3,9918,10440
2.10E+12,310,1199,24.1,4980,1199,1,3781,4980
1.00E+12,310,548,10,5480,548,1,4932,5480
1.00E+12,310,858,10,8580,2574,3,23166,25740
7424118,310,378,10,3780,378,1,3402,3780
6609929,310,1148,10,11480,2296,2,20664,22960
1.00E+12,100,69,2,3480,69,1,3411,3480
2.10E+12,200,2110,23.5,8980,12659,6,41221,53880
1.00E+12,310,649,8.1,7980,649,1,7331,7980
1.00E+12,310,616,8.1,7580,616,1,6964,7580
1.00E+12,310,1098,9.2,11980,1098,1,10882,11980
10529379,310,456,9.2,4980,456,1,4524,4980
2.10E+12,310,149,5,2980,298,2,5662,5960
2.10E+12,310,6633,33.5,19800,26532,4,52668,79200
2.10E+12,200,6633,33.5,19800,33165,5,65835,99000
1.00E+12,310,99,5,1980,594,6,11286,11880
1.00E+12,100,5252,19.6,26800,5252,1,21548,26800
1.00E+12,200,5252,19.6,26800,5252,1,21548,26800
1.00E+12,300,7900,10,79000,15800,2,142200,158000
1.00E+12,310,705,11.8,5980,705,1,5275,5980
8255625,100,292,11.8,2480,292,1,2188,2480
1.00E+12,100,4480,14.5,30900,4480,1,26420,30900
1.00E+12,310,1850,10,18500,3700,2,33300,37000
1.00E+12,310,1669,15.5,10780,1669,1,9111,10780
1.00E+12,200,3331,20.9,15900,3331,1,12569,15900
1.00E+12,200,1801,20.9,8600,1801,1,6799,8600
1.00E+12,310,1290,5,25800,11610,9,220590,232200
1.00E+12,310,4950,5,99000,4950,1,94050,99000
7141873,310,249,5,4980,249,1,4731,4980
8631011,340,720,6.9,10480,720,1,9760,10480
1.00E+12,511,170,16.7,1020,4080,24,20400,24480
1.00E+12,500,5700,15,38000,5700,1,32300,38000
1.00E+12,200,7742,16.3,47500,7742,1,39758,47500
1.00E+12,200,4000,20,20000,4000,1,16000,20000
1.00E+12,310,281,19,1480,281,1,1199,1480
1.00E+12,310,1738,7,24880,1738,1,23142,24880
1.00E+12,310,398,7,5700,796,2,10604,11400
1.00E+12,310,173,7,2480,173,1,2307,2480
1.00E+12,310,499,5,9980,499,1,9481,9980
2.10E+12,310,2238,37,6050,2238,1,3812,6050
1.00E+12,310,120,10,1200,120,1,1080,1200
1.00E+12,310,238,10,2380,952,4,8568,9520
1.00E+12,300,11472,12.6,91200,11472,1,79728,91200
7390426,310,292,7,4180,292,1,3888,4180
8554664,310,245,7,3500,245,1,3255,3500
1.00E+12,310,339,9,3780,339,1,3441,3780
1.00E+12,200,1280,8,16000,1280,1,14720,16000
1.00E+12,100,4990,10,49900,4990,1,44910,49900
1.00E+12,100,495,5,9900,495,1,9405,9900
1.00E+12,100,94,5,1880,94,1,1786,1880
1.00E+12,100,99,5,1980,99,1,1881,1980
1.00E+12,240,409,14.7,2780,409,1,2371,2780
6835815,310,103,5.2,1980,103,1,1877,1980
7242787,310,204,5.2,3880,407,2,7353,7760
6916804,310,366,5.2,6980,366,1,6614,6980
1.00E+12,310,419,5.3,7980,419,1,7561,7980
6609253,310,524,5.3,9980,524,1,9456,9980
1.00E+12,310,829,5.2,15800,829,1,14971,15800
1.00E+12,310,197,9.9,1980,197,1,1783,1980
8410596,310,118,10,1180,235,2,2125,2360
1.00E+12,310,208,7,2980,208,1,2772,2980
,,,,,,,,
1.00E+12,310,698,7,9980,698,1,9282,9980
2.10E+12,200,1693,15.5,10900,1693,1,9207,10900
1.00E+12,310,83,8.5,980,83,1,897,980
1.00E+12,310,491,17.7,2780,982,2,4578,5560
1.00E+12,200,25200,15,168000,25200,1,142800,168000
1.00E+12,511,1967,33.3,5900,11800,6,23600,35400
2.10E+12,310,1854,7.5,24800,3708,2,45892,49600
1.00E+12,310,89,7.4,1200,89,1,1111,1200
1.00E+12,500,7096,25.3,28080,7096,1,20984,28080
1.00E+12,310,3963,18.1,21900,3963,1,17937,21900
1.00E+12,200,2993,15.3,19500,5986,2,33014,39000
,,,,,,,,
1.00E+12,200,1113,7,15900,1113,1,14787,15900
1.00E+12,310,271,8.5,3200,271,1,2929,3200
1.00E+12,310,123,1,11900,123,1,11777,11900
8844842,310,48,1,4650,48,1,4602,4650
6618823,310,208,10,2080,1040,5,9360,10400
1.00E+12,310,145,10,1450,1015,7,9135,10150
7049673,100,18,2,900,72,4,3528,3600
1.00E+12,200,1577,7,22540,1577,1,20963,22540
1.00E+12,310,908,7,12980,908,1,12072,12980
1.00E+12,200,6784,25.6,26500,6784,1,19716,26500
1.00E+12,200,5800,20,29000,5800,1,23200,29000
1.00E+12,200,2288,14.5,15780,2288,1,13492,15780
9654374,310,598,10,5980,3588,6,32292,35880
1.00E+12,200,1670,8,20900,1670,1,19230,20900
1.00E+12,200,3900,15,26000,3900,1,22100,26000
9526026,310,348,7,4980,1044,3,13896,14940
1.00E+12,200,7500,25,30000,7500,1,22500,30000
1.00E+12,310,241,9.7,2480,482,2,4478,4960
2.10E+12,340,1880,34.3,5480,1880,1,3600,5480
1.00E+12,310,60,5,1200,660,11,12540,13200
1.00E+12,300,6353,14.4,44000,6353,1,37647,44000
7938700,511,7964,55,14480,47784,6,39096,86880
1.00E+12,200,15360,25.6,60000,15360,1,44640,60000
7097773,100,495,5,9900,495,1,9405,9900
1.00E+12,100,498,10,4980,498,1,4482,4980
1.00E+12,100,299,5,5980,299,1,5681,5980
6609427,100,245,10,2450,245,1,2205,2450
1.00E+12,100,1000,10,10000,1000,1,9000,10000
1.00E+12,310,1598,10,15980,1598,1,14382,15980
1.00E+12,310,3892,28,13900,7784,2,20016,27800
2.10E+12,200,1149,28.9,3980,1149,1,2831,3980
2.10E+12,200,1776,20.9,8480,7104,4,26816,33920
2.10E+12,340,420,7,6000,420,1,5580,6000
8333554,310,119,12.5,950,237,2,1663,1900
1.00E+12,310,10599,17,62400,10599,1,51801,62400
1.00E+12,200,9466,12.4,76500,9466,1,67034,76500
1.00E+12,300,13800,10,138000,13800,1,124200,138000
1.00E+12,310,119,5,2380,357,3,6783,7140
1.00E+12,601,612,9.7,6280,612,1,5668,6280
1.00E+12,310,119,5,2380,1071,9,20349,21420
1.00E+12,200,9060,16.5,55000,9060,1,45940,55000
1.00E+12,310,272,6.8,3980,272,1,3708,3980
1.00E+12,310,238,6.8,3480,238,1,3242,3480
1.00E+12,310,452,6.8,6600,452,1,6148,6600
1.00E+12,200,450,3,15000,900,2,29100,30000
1.00E+12,340,224,7,3200,224,1,2976,3200
2.10E+12,340,173,7,2480,346,2,4614,4960
1.00E+12,310,84,5,1680,1512,18,28728,30240
1.00E+12,310,179,5,3580,358,2,6802,7160
1.00E+12,310,896,9.1,9900,896,1,9004,9900
1.00E+12,310,430,9,4780,430,1,4350,4780
1.00E+12,310,133,9,1480,266,2,2694,2960
1.00E+12,240,680,10,6800,680,1,6120,6800
1.00E+12,240,250,10,2500,250,1,2250,2500
7216254,310,265,7.4,3600,265,1,3335,3600
1.00E+12,310,3682,7.4,49900,3682,1,46218,49900
2.10E+12,200,1773,25.9,6850,1773,1,5077,6850
2.10E+12,200,1807,25.9,6980,1807,1,5173,6980
2.10E+12,100,696,11.6,5980,696,1,5284,5980
2.10E+12,340,696,11.6,5980,696,1,5284,5980
6848650,100,1538,31.4,4900,1538,1,3362,4900
1.00E+12,310,238,10,2380,1190,5,10710,11900
1.00E+12,310,438,10,4380,438,1,3942,4380
1.00E+12,300,2000,13.4,14980,2000,1,12980,14980
1.00E+12,300,958,20,4790,1916,2,7664,9580
2.10E+12,310,2303,23.5,9800,11515,5,37485,49000
1.00E+12,310,68,6.9,980,204,3,2736,2940
1.00E+12,310,349,7,4990,349,1,4641,4990
1.00E+12,200,8556,7.8,109000,8556,1,100444,109000
1.00E+12,240,757,16.3,4650,1514,2,7786,9300
7632909,240,586,16.3,3600,586,1,3014,3600
1.00E+12,340,302,7,4320,302,1,4018,4320
1.00E+12,310,194,7,2780,194,1,2586,2780
1.00E+12,200,10710,16.5,65000,10710,1,54290,65000
1.00E+12,200,12040,8.2,147000,12040,1,134960,147000
1.00E+12,310,15464,25.8,60000,15464,1,44536,60000
1.00E+12,200,680,6,11400,680,1,10720,11400
7216254,100,360,10,3600,360,1,3240,3600
1.00E+12,310,785,7.9,9880,785,1,9095,9880
6609028,310,77,7,1100,77,1,1023,1100
1.00E+12,200,12960,6.5,199000,12960,1,186040,199000
1.00E+12,200,12960,6.5,199000,12960,1,186040,199000
1.00E+12,310,269,5,5380,269,1,5111,5380
1.00E+12,240,1163,32.5,3580,1163,1,2417,3580
2.10E+12,310,1918,28,6850,1918,1,4932,6850
6611425,310,320,5,6400,320,1,6080,6400
1.00E+12,310,164,5,3290,164,1,3126,3290
1.00E+12,310,274,5,5480,274,1,5206,5480
1.00E+12,310,278,7,3980,278,1,3702,3980
7707159,310,299,7,4280,1495,5,19905,21400
1.00E+12,500,1200,5,24000,6000,5,114000,120000
8090941,310,334,7,4780,1002,3,13338,14340
1.00E+12,310,138,7,1980,1932,14,25788,27720
1.00E+12,310,3480,10,34800,10440,3,93960,104400
8038410,310,145,5,2900,145,1,2755,2900
8783909,310,294,5,5880,294,1,5586,5880
1.00E+12,240,2070,16,12900,4140,2,21660,25800
1.00E+12,200,894,6,14900,894,1,14006,14900
1.00E+12,340,831,9.7,8580,831,1,7749,8580
7175432,310,270,7.5,3600,270,1,3330,3600
1.00E+12,310,2939,7.6,38900,2939,1,35961,38900
1.00E+12,310,69,7,990,138,2,1842,1980
1.00E+12,310,138,7,1980,276,2,3684,3960
1.00E+12,310,1132,8.7,12980,1132,1,11848,12980
2.10E+12,200,3000,20.3,14800,6000,2,23600,29600
1.00E+12,310,795,10,7980,795,1,7185,7980
2.10E+12,310,1339,11.6,11500,1339,1,10161,11500
1.00E+12,200,5392,40,13480,10784,2,16176,26960
1.00E+12,310,98,10,980,98,1,882,980
8328977,310,186,19,980,744,4,3176,3920
1.00E+12,200,638,14.5,4400,3190,5,18810,22000
1.00E+12,310,1226,25.1,4880,1226,1,3654,4880
2.10E+12,310,329,9.4,3500,329,1,3171,3500
2.10E+12,200,2972,27.5,10800,2972,1,7828,10800
2.10E+12,310,187,7,2680,561,3,7479,8040
1.00E+12,310,1132,9.4,11980,1132,1,10848,11980
1.00E+12,240,756,19,3980,756,1,3224,3980
6845375,340,320,7,4580,320,1,4260,4580
1.00E+12,340,525,7,7500,525,1,6975,7500
1.00E+12,310,140,7,2000,140,1,1860,2000
6609263,310,245,7,3500,490,2,6510,7000
1.00E+12,200,7200,20,36000,7200,1,28800,36000
1.00E+12,200,2600,10,26000,2600,1,23400,26000
2.10E+12,310,3343,33.5,9980,10029,3,19911,29940
2.10E+12,310,274,5,5480,548,2,10412,10960
2.10E+12,310,299,5,5980,1495,5,28405,29900
7411087,310,348,10,3480,348,1,3132,3480
1.00E+12,310,404,11.2,3600,404,1,3196,3600
1.00E+12,310,4670,15.7,29800,4670,1,25130,29800
10533151,310,269,10,2690,538,2,4842,5380
6618856,310,328,10,3280,656,2,5904,6560
7694532,310,435,8.5,5100,435,1,4665,5100
6615244,310,153,8.5,1800,153,1,1647,1800
2.10E+12,200,14720,36,40890,14720,1,26170,40890
1.00E+12,200,5750,5,115000,5750,1,109250,115000
1.00E+12,310,11980,20,59900,23960,2,95840,119800
1.00E+12,340,159,7,2280,159,1,2121,2280
1.00E+12,340,159,7,2280,159,1,2121,2280
1.00E+12,310,201,7,2880,201,1,2679,2880
1.00E+12,200,2175,5,43500,4350,2,82650,87000
1.00E+12,310,485,8.5,5680,1938,4,20782,22720
1.00E+12,310,458,8.5,5380,458,1,4922,5380
9656160,310,245,8.5,2880,245,1,2635,2880
1.00E+12,200,3765,16.3,23100,3765,1,19335,23100
1.00E+12,340,142,4.9,2900,142,1,2758,2900
1.00E+12,340,195,4.9,3980,195,1,3785,3980
1.00E+12,200,10721,20.8,51500,10721,1,40779,51500
1.00E+12,340,10721,20.8,51500,10721,1,40779,51500
1.00E+12,501,10721,20.8,51500,10721,1,40779,51500
1.00E+12,310,1173,4,29000,1173,1,27827,29000
1.00E+12,310,512,6.9,7400,512,1,6888,7400
1.00E+12,310,2816,4,69600,2816,1,66784,69600
9655084,310,770,7,11000,770,1,10230,11000
2.10E+12,310,273,7,3900,819,3,10881,11700
1.00E+12,100,174,11.8,1480,174,1,1306,1480
10219983,501,7,1.8,398,28,4,1564,1592
1.00E+12,205,654,30,2180,1962,3,4578,6540
1.00E+12,310,2615,52.5,4980,5229,2,4731,9960
6609067,310,64,5,1280,256,4,4864,5120
1.00E+12,310,349,5,6980,2443,7,46417,48860
1.00E+12,511,2615,52.5,4980,5229,2,4731,9960
7594661,310,560,7,7980,560,1,7420,7980
2.10E+12,310,560,7,7980,2241,4,29679,31920
1.00E+12,310,244,7,3480,244,1,3236,3480
6609443,240,682,16.3,4180,1364,2,6996,8360
2.10E+12,240,1760,20,8800,1760,1,7040,8800
1.00E+12,310,1061,8.9,11980,1061,1,10919,11980
7909931,310,224,8.9,2530,224,1,2306,2530
10732911,240,142,14.5,980,710,5,4190,4900
1.00E+12,310,887,10,8900,887,1,8013,8900
1.00E+12,310,845,10,8480,845,1,7635,8480
1.00E+12,310,129,5,2580,387,3,7353,7740
1.00E+12,200,2059,20.8,9900,2059,1,7841,9900
1.00E+12,310,739,8.6,8580,739,1,7841,8580
1.00E+12,310,250,8.4,2980,250,1,2730,2980
1.00E+12,200,16240,10.4,156000,16240,1,139760,156000
1.00E+12,310,648,16.3,3980,1296,2,6664,7960
1.00E+12,310,567,8.9,6400,1134,2,11666,12800
1.00E+12,100,685,24.6,2780,1370,2,4190,5560
1.00E+12,100,648,16.3,3980,1296,2,6664,7960
1.00E+12,200,6500,10,65000,6500,1,58500,65000
1.00E+12,100,99,10,990,198,2,1782,1980
1.00E+12,310,149,5,2980,298,2,5662,5960
2.10E+12,310,149,5,2980,149,1,2831,2980
1.00E+12,310,240,5,4800,720,3,13680,14400
1.00E+12,205,4794,30,15980,14382,3,33558,47940
10354256,310,207,9.1,2280,207,1,2073,2280
10040524,310,815,9.1,8980,815,1,8165,8980
8986773,310,161,9,1780,161,1,1619,1780
1.00E+12,310,125,10,1250,125,1,1125,1250
8629711,310,3698,10,36980,11094,3,99846,110940
1.00E+12,310,2849,5.8,48980,8548,3,138392,146940
1.00E+12,200,1740,14.5,12000,15660,9,92340,108000
1.00E+12,310,222,7,3180,222,1,2958,3180
8233374,310,236,6.8,3480,236,1,3244,3480
1.00E+12,310,474,6.8,6980,474,1,6506,6980
6609061,310,358,6.8,5280,358,1,4922,5280
1.00E+12,310,1190,10,11900,3570,3,32130,35700
7235501,310,150,10,1500,150,1,1350,1500
1.00E+12,310,120,10,1200,120,1,1080,1200
8642235,310,939,14.5,6480,1878,2,11082,12960
6615122,310,1212,19,6380,7272,6,31008,38280
1.00E+12,300,16300,16.3,100000,16300,1,83700,100000
1.00E+12,310,11760,28,42000,11760,1,30240,42000
1.00E+12,200,10720,23.3,46000,10720,1,35280,46000
1.00E+12,300,10720,23.3,46000,10720,1,35280,46000
1.00E+12,300,7210,24.9,29000,7210,1,21790,29000
1.00E+12,310,124,5,2480,372,3,7068,7440
7335722,310,129,5,2580,129,1,2451,2580
1.00E+12,310,1990,10,19900,1990,1,17910,19900
1.00E+12,100,645,5,12900,645,1,12255,12900
10354256,310,205,9,2280,205,1,2075,2280
1.00E+12,200,1040,10,10400,2080,2,18720,20800
1.00E+12,200,28350,15,189000,85050,3,481950,567000
2.10E+12,200,495,25,1980,9405,19,28215,37620
1.00E+12,200,1962,18,10900,1962,1,8938,10900
1.00E+12,310,998,10,9980,998,1,8982,9980
7691345,310,943,10,9430,1886,2,16974,18860
1.00E+12,200,218,10,2180,5450,25,49050,54500
8421196,310,1687,19,8880,1687,1,7193,8880
1.00E+12,310,1119,8.6,12980,1119,1,11861,12980
1.00E+12,310,167,7,2390,1002,6,13338,14340
1.00E+12,310,750,9.8,7680,750,1,6930,7680
1.00E+12,310,258,10,2580,1548,6,13932,15480
1.00E+12,310,99,5,1980,99,1,1881,1980
6609049,310,54,5,1080,54,1,1026,1080
1.00E+12,200,33967,18,189000,33967,1,155033,189000
1.00E+12,300,413,7,5900,4130,10,54870,59000
1.00E+12,240,298,10,2980,1788,6,16092,17880
2.10E+12,100,94,5,1880,94,1,1786,1880
8241054,310,385,10,3850,770,2,6930,7700
1.00E+12,310,75,7.6,980,1345,18,16295,17640
1.00E+12,310,278,7,3980,278,1,3702,3980
1.00E+12,310,1710,19,9000,1710,1,7290,9000
1.00E+12,100,576,11.6,4950,1152,2,8748,9900
1.00E+12,100,1431,16.3,8780,1431,1,7349,8780
2.10E+12,100,858,9.8,8800,858,1,7942,8800
7632909,310,360,10,3600,360,1,3240,3600
1.00E+12,310,280,7,4000,1120,4,14880,16000
1.00E+12,340,4055,16.3,24880,4055,1,20825,24880
6610188,310,74,7.9,940,74,1,866,940
1.00E+12,310,671,9.6,6980,671,1,6309,6980
1.00E+12,310,15171,36.7,41300,30341,2,52259,82600
1.00E+12,310,117,7,1680,351,3,4689,5040
1.00E+12,310,180,7,2580,540,3,7200,7740
1.00E+12,200,3000,10,30000,6000,2,54000,60000
1.00E+12,340,830,9.7,8580,830,1,7750,8580
1.00E+12,310,4114,55,7480,41140,10,33660,74800
1.00E+12,511,3962,53,7480,7924,2,7036,14960
1.00E+12,310,296,5.9,4980,296,1,4684,4980
1.00E+12,100,699,8.8,7900,699,1,7201,7900
1.00E+12,100,1639,8.9,18500,1639,1,16861,18500
2.10E+12,205,800,9.4,8480,2400,3,23040,25440
8593950,310,294,8.2,3600,294,1,3306,3600
1.00E+12,310,301,8.2,3680,301,1,3379,3680
2.10E+12,310,940,8.2,11480,940,1,10540,11480
1.00E+12,100,463,11.6,3980,926,2,7034,7960
1.00E+12,310,64,5,1280,256,4,4864,5120
1.00E+12,200,11850,15,79000,11850,1,67150,79000
1.00E+12,200,2250,15,15000,2250,1,12750,15000
1.00E+12,200,36630,20.5,179100,36630,1,142470,179100
1.00E+12,200,13800,20,69000,27600,2,110400,138000
1.00E+12,200,12900,20,64500,12900,1,51600,64500
6610869,240,320,13.1,2450,320,1,2130,2450
1.00E+12,310,30,3.4,880,60,2,1700,1760
1.00E+12,310,199,3.4,5800,397,2,11203,11600
1.00E+12,310,102,3.4,2980,102,1,2878,2980
6610869,310,320,13.1,2450,320,1,2130,2450
7150833,601,411,8.2,4990,411,1,4579,4990
1.00E+12,340,135,5.6,2390,135,1,2255,2390
8369316,340,225,5.7,3980,225,1,3755,3980
1.00E+12,200,14140,20,70740,14140,1,56600,70740
2037198,200,6000,15,40000,6000,1,34000,40000
1.00E+12,310,390,10,3900,390,1,3510,3900
1.00E+12,501,1255,10.5,11900,1255,1,10645,11900
1.00E+12,310,430,10,4300,860,2,7740,8600
1.00E+12,310,920,10,9200,920,1,8280,9200
1.00E+12,310,366,10.5,3480,366,1,3114,3480
2.10E+12,310,189,10.5,1800,189,1,1611,1800
7332554,310,320,10.5,3040,320,1,2720,3040
2.10E+12,310,2048,37.4,5480,2048,1,3432,5480
7332554,100,320,10.5,3040,320,1,2720,3040
10698740,501,894,10.5,8480,894,1,7586,8480
6614737,601,635,14.5,4380,635,1,3745,4380
8333640,601,652,14.5,4500,652,1,3848,4500
2.10E+12,310,1398,28.1,4980,2796,2,7164,9960
1.00E+12,310,348,10,3480,696,2,6264,6960
1.00E+12,100,7950,5,159000,7950,1,151050,159000
8986773,310,178,10,1780,1602,9,14418,16020
1.00E+12,310,3200,10,32000,3200,1,28800,32000
1.00E+12,310,24179,5.1,472660,24179,1,448481,472660
1.00E+12,200,1250,5,25000,1250,1,23750,25000
1.00E+12,310,3288,33.6,9780,13152,4,25968,39120
1.00E+12,240,387,16.3,2380,1548,4,7972,9520
1.00E+12,205,3288,33.6,9780,13152,4,25968,39120
1.00E+12,310,960,9.6,9980,960,1,9020,9980
1.00E+12,300,1500,14.3,10480,6000,4,35920,41920
1.00E+12,200,590,2,28900,590,1,28310,28900
1.00E+12,100,570,16.3,3500,570,1,2930,3500
1.00E+12,310,4990,10,49900,9980,2,89820,99800
1.00E+12,200,1930,15,12900,1930,1,10970,12900
1.00E+12,200,290,14.6,1990,870,3,5100,5970
1.00E+12,100,3839,55,6980,15356,4,12564,27920
6609807,100,1170,28,4180,2340,2,6020,8360
1.00E+12,200,300,3,10000,300,1,9700,10000
2.10E+12,200,245,10,2450,735,3,6615,7350
6616441,205,5360,20,26800,10720,2,42880,53600
1.00E+12,200,1829,31,5900,1829,1,4071,5900
1.00E+12,100,13762,16.2,84900,13762,1,71138,84900
1.00E+12,310,8471,10.4,81700,8471,1,73229,81700
1.00E+12,310,1858,18.8,9900,5574,3,24126,29700
1.00E+12,200,5594,18.8,29800,5594,1,24206,29800
1.00E+12,200,7020,18,39000,7020,1,31980,39000
1.00E+12,200,16320,24,68000,16320,1,51680,68000
1.00E+12,200,1116,4,27900,1116,1,26784,27900
1.00E+12,310,103,4.7,2180,103,1,2077,2180
6822284,310,169,4.7,3580,169,1,3411,3580
1.00E+12,310,283,4.7,5990,283,1,5707,5990
1.00E+12,310,360,3.6,9980,360,1,9620,9980
1.00E+12,240,1666,8.8,19000,1666,1,17334,19000
8583141,310,161,4.2,3840,642,4,14718,15360
2.10E+12,310,153,4.2,3680,306,2,7054,7360
6609769,310,52,4.2,1250,104,2,2396,2500
6610889,310,279,4.2,6680,558,2,12802,13360
1.00E+12,200,5170,23.5,22000,5170,1,16830,22000
1.00E+12,240,12320,44,28000,12320,1,15680,28000
10529800,205,654,30,2180,1962,3,4578,6540
,,,,,,,,
1.00E+12,100,59,1,5980,59,1,5921,5980
1.00E+12,310,2615,52.5,4980,10458,4,9462,19920
1.00E+12,310,124,5,2480,248,2,4712,4960
1.00E+12,200,2585,14.4,17900,2585,1,15315,17900
1.00E+12,310,148,5,2960,148,1,2812,2960
8093106,511,3025,50,6050,12100,4,12100,24200
8023235,501,9,0.9,980,9,1,971,980
1.00E+12,310,2230,10,22300,2230,1,20070,22300
1.00E+12,310,4541,19,23900,4541,1,19359,23900
2.10E+12,310,138,10,1380,138,1,1242,1380
1.00E+12,501,6259,11.6,54000,6259,1,47741,54000
6610161,310,351,9,3900,351,1,3549,3900
7858987,310,798,10,7980,1596,2,14364,15960
6609534,310,248,10,2480,496,2,4464,4960
1.00E+12,200,8500,10,85000,8500,1,76500,85000
1.00E+12,300,2681,9.7,27500,2681,1,24819,27500
1.00E+12,310,1929,9.7,19980,1929,1,18051,19980
1.00E+12,310,97,12.4,780,193,2,1367,1560
1.00E+12,240,97,12.4,780,193,2,1367,1560
8901005,310,663,7,9480,663,1,8817,9480
8231610,310,898,10,8980,898,1,8082,8980
1.00E+12,310,471,19,2480,942,2,4018,4960
1.00E+12,310,258,10,2580,774,3,6966,7740
1.00E+12,200,5560,10,55600,5560,1,50040,55600
6835815,310,287,14.5,1980,1148,4,6772,7920
8462694,310,262,19,1380,262,1,1118,1380
1.00E+12,100,287,14.5,1980,287,1,1693,1980
1.00E+12,100,722,14.5,4980,722,1,4258,4980
1.00E+12,200,9846,18.6,53000,9846,1,43154,53000
1.00E+12,310,24,4.9,490,480,20,9320,9800
7150454,310,128,10,1280,256,2,2304,2560
10701317,310,616,7,8800,616,1,8184,8800
1.00E+12,310,278,7,3980,278,1,3702,3980
1.00E+12,100,202,5,4050,202,1,3848,4050
1.00E+12,100,249,5,4980,249,1,4731,4980
1.00E+12,310,4349,4.7,91900,4349,1,87551,91900
1.00E+12,200,8170,19,43000,8170,1,34830,43000
1.00E+12,500,5150,16.3,31600,10300,2,52900,63200
1.00E+12,310,730,16.3,4480,730,1,3750,4480
1.00E+12,240,730,16.3,4480,730,1,3750,4480
1.00E+12,310,465,7.8,5980,465,1,5515,5980
1.00E+12,200,6422,18.4,34900,12843,2,56957,69800
2.10E+12,310,1452,9.7,14900,1452,1,13448,14900
1.00E+12,200,12500,25,50000,12500,1,37500,50000
1.00E+12,200,11704,19,61600,11704,1,49896,61600
1.00E+12,200,1695,10,16950,1695,1,15255,16950
7590654,310,208,7,2980,416,2,5544,5960
1.00E+12,200,1370,5,27500,1370,1,26130,27500
1.00E+12,310,784,9.8,7980,784,1,7196,7980
9527114,310,440,9.8,4480,440,1,4040,4480
1.00E+12,310,238,10,2380,4046,17,36414,40460
1.00E+12,310,309,5,6180,309,1,5871,6180
1.00E+12,310,399,5,7980,1596,4,30324,31920
1.00E+12,310,2497,5,49940,2497,1,47443,49940
2.10E+12,310,680,10,6800,1360,2,12240,13600
7095596,310,211,8.8,2390,844,4,8716,9560
6610869,310,439,17.9,2450,439,1,2011,2450
1.00E+12,310,1458,10,14580,1458,1,13122,14580
1.00E+12,310,607,8.7,6980,607,1,6373,6980
1.00E+12,310,259,8.7,2980,259,1,2721,2980
1.00E+12,200,8850,15,59000,8850,1,50150,59000
1.00E+12,310,833,7,11900,1666,2,22134,23800
1.00E+12,200,4590,13.5,33980,9180,2,58780,67960
1.00E+12,200,4350,14,31000,4350,1,26650,31000
1.00E+12,310,6335,19.5,32500,6335,1,26165,32500
1.00E+12,200,2630,8,32900,2630,1,30270,32900
1.00E+12,310,149,5,2980,298,2,5662,5960
1.00E+12,310,99,5,1980,99,1,1881,1980
1.00E+12,200,4610,13.6,33900,4610,1,29290,33900
1.00E+12,310,698,7,9980,698,1,9282,9980
1.00E+12,310,590,10,5900,590,1,5310,5900
2.10E+12,310,379,9.5,3980,379,1,3601,3980
1.00E+12,300,21516,16.3,132000,21516,1,110484,132000
1.00E+12,310,348,7,4980,348,1,4632,4980
1.00E+12,100,5184,24,21600,5184,1,16416,21600
1.00E+12,200,5184,24,21600,5184,1,16416,21600
1.00E+12,340,1230,7,17580,1230,1,16350,17580
10627392,310,216,5,4320,432,2,8208,8640
1.00E+12,511,5529,55.8,9900,11058,2,8742,19800
1.00E+12,205,1490,50,2980,7450,5,7450,14900
1.00E+12,310,797,14.5,5500,797,1,4703,5500
7350960,601,909,23,3950,909,1,3041,3950
8882973,100,1801,19,9480,1801,1,7679,9480
1.00E+12,100,2989,29.9,10000,2989,1,7011,10000
7350960,100,909,23,3950,909,1,3041,3950
1.00E+12,310,2421,7.7,31620,2421,1,29199,31620
1.00E+12,310,4990,13.2,37800,4990,1,32810,37800
8075569,310,770,9.9,7800,770,1,7030,7800
2.10E+12,310,126,9.8,1280,377,3,3463,3840
8976246,310,77,9.9,780,925,12,8435,9360
1.00E+12,310,763,7,10900,2289,3,30411,32700
1.00E+12,310,826,7,11800,826,1,10974,11800
1.00E+12,310,50200,18.7,268000,50200,1,217800,268000
1.00E+12,310,499,5,9980,998,2,18962,19960
4894175,200,23860,12.1,198000,71580,3,522420,594000
2.10E+12,310,332,11.1,2980,332,1,2648,2980
8210715,310,387,11.1,3480,387,1,3093,3480
2.10E+12,310,696,20,3480,696,1,2784,3480
7936333,100,2279,32.7,6980,4558,2,9402,13960
1.00E+12,200,46210,21.7,213000,46210,1,166790,213000
1.00E+12,310,359,14.5,2480,359,1,2121,2480
1.00E+12,310,298,10,2980,1788,6,16092,17880
1.00E+12,310,249,5,4980,249,1,4731,4980
1.00E+12,310,1484,9.3,15980,1484,1,14496,15980
2.10E+12,340,89,7,1280,178,2,2382,2560
2.10E+12,310,201,5.7,3500,201,1,3299,3500
2.10E+12,310,173,5.8,3000,345,2,5655,6000
1.00E+12,310,200,5.7,3480,200,1,3280,3480
1.00E+12,310,112,5.7,1950,112,1,1838,1950
1.00E+12,310,5661,35.8,15800,5661,1,10139,15800
1.00E+12,240,548,10,5480,548,1,4932,5480
7626826,310,355,10,3550,710,2,6390,7100
1.00E+12,310,188,10,1880,188,1,1692,1880
1.00E+12,310,683,7.6,8980,683,1,8297,8980
1.00E+12,310,278,7,3980,834,3,11106,11940
10533274,310,243,7,3480,486,2,6474,6960
2.10E+12,310,13042,28,46580,26084,2,67076,93160
1.00E+12,310,208,7,2980,416,2,5544,5960
1.00E+12,310,243,7,3480,972,4,12948,13920
1.00E+12,200,5000,10,50000,5000,1,45000,50000
1.00E+12,310,208,7,2980,416,2,5544,5960
7622804,310,600,7,8580,1800,3,23940,25740
7648612,310,126,7,1800,126,1,1674,1800
8410655,310,154,7,2200,154,1,2046,2200
1.00E+12,100,3080,16.3,18900,3080,1,15820,18900
1.00E+12,310,504,14.5,3480,504,1,2976,3480
1.00E+12,100,992,14.5,6850,992,1,5858,6850
1.00E+12,200,52679,25.3,208600,52679,1,155921,208600
1.00E+12,310,601,7.5,7980,601,1,7379,7980
8631445,310,526,7.5,6980,526,1,6454,6980
1.00E+12,310,413,7.5,5480,413,1,5067,5480
1.00E+12,310,300,7.5,3980,300,1,3680,3980
2.10E+12,310,1806,7,25800,1806,1,23994,25800
2.10E+12,310,3100,20.9,14800,12400,4,46800,59200
1.00E+12,310,2887,38,7600,8662,3,14138,22800
1.00E+12,310,2887,38,7600,8662,3,14138,22800
1.00E+12,200,7149,23.8,30000,7149,1,22851,30000
1.00E+12,300,7149,23.8,30000,7149,1,22851,30000
1.00E+12,300,11890,14.5,82000,11890,1,70110,82000
8333610,310,385,9.2,4200,385,1,3815,4200
1.00E+12,310,11980,20,59900,11980,1,47920,59900
1.00E+12,310,748,10,7480,1496,2,13464,14960
1.00E+12,200,10620,18,59000,10620,1,48380,59000
6610050,310,2129,53.5,3980,21290,10,18510,39800
9069419,310,418,7,5980,418,1,5562,5980
1.00E+12,300,990,20,4950,990,1,3960,4950
2.10E+12,310,260,8.7,2980,260,1,2720,2980
2.10E+12,310,7223,36.2,19980,7223,1,12757,19980
8634654,310,384,5,7680,384,1,7296,7680
1.00E+12,310,344,5,6880,344,1,6536,6880
8781565,310,149,5,2980,596,4,11324,11920
1.00E+12,310,75,10,750,75,1,675,750
1.00E+12,100,229,14.5,1580,1145,5,6755,7900
8553755,310,350,10,3500,350,1,3150,3500
6609755,310,437,7.3,5980,437,1,5543,5980
8333644,310,69,7.3,950,138,2,1762,1900
1.00E+12,200,5752,9.7,59000,5752,1,53248,59000
1.00E+12,310,138,7,1980,138,1,1842,1980
1.00E+12,310,780,10,7800,780,1,7020,7800
1.00E+12,200,31240,24.2,129000,31240,1,97760,129000
1.00E+12,300,31240,24.2,129000,31240,1,97760,129000
8901004,310,761,7,10880,761,1,10119,10880
7500148,310,150,10,1500,300,2,2700,3000
2.10E+12,310,770,10,7700,770,1,6930,7700
1.00E+12,310,19575,23.5,83300,19575,1,63725,83300
2.10E+12,310,178,9,1980,356,2,3604,3960
1.00E+12,310,1252,9,13900,1252,1,12648,13900
1.00E+12,200,757,17.2,4400,3027,4,14573,17600
1.00E+12,310,202,5.1,3980,202,1,3778,3980
1.00E+12,310,132,10,1320,264,2,2376,2640
1.00E+12,310,198,10,1980,594,3,5346,5940
1.00E+12,310,644,18.4,3500,644,1,2856,3500
1.00E+12,310,40,9.4,430,805,20,7795,8600
1.00E+12,310,1088,18.4,5900,6527,6,28873,35400
1.00E+12,100,2769,31.1,8900,5538,2,12262,17800
1.00E+12,310,99,10,990,396,4,3564,3960
1.00E+12,100,38,1,3800,76,2,7524,7600
8120848,501,9,0.9,990,18,2,1962,1980
1.00E+12,310,236,6.2,3780,236,1,3544,3780
2.10E+12,200,500,11.1,4500,500,1,4000,4500
1.00E+12,310,273,9.8,2780,273,1,2507,2780
1.00E+12,310,273,9.5,2880,273,1,2607,2880
9669780,310,557,9.5,5880,557,1,5323,5880
9699059,310,1328,9.5,13980,2655,2,25305,27960
7549002,310,141,4.9,2850,141,1,2709,2850
1.00E+12,240,1083,14.5,7480,2166,2,12794,14960
1.00E+12,300,556,20,2780,1112,2,4448,5560
2.10E+12,200,2000,13.5,14800,4000,2,25600,29600
1.00E+12,200,14890,36.1,41300,59560,4,105640,165200
1.00E+12,205,5727,23,24900,17181,3,57519,74700
1.00E+12,511,1340,50,2680,8040,6,8040,16080
1.00E+12,340,752,5.8,12900,752,1,12148,12900
8517872,340,390,5.8,6700,390,1,6310,6700
2.10E+12,310,553,7,7900,553,1,7347,7900
2.10E+12,310,7902,39.5,19980,47412,6,72468,119880
2.10E+12,200,243,15,1620,3159,13,17901,21060
2.10E+12,200,7902,39.5,19980,47412,6,72468,119880
2.10E+12,310,429,8.1,5300,429,1,4871,5300
1.00E+12,310,1480,10,14800,2960,2,26640,29600
10229295,310,488,10,4880,488,1,4392,4880
1.00E+12,601,767,5.9,12900,767,1,12133,12900
8562095,100,37,1,3780,37,1,3743,3780
1.00E+12,501,49,1,4980,98,2,9862,9960
1.00E+12,200,1425,5,28500,1425,1,27075,28500
2.10E+12,200,8743,35,24980,17486,2,32474,49960
1.00E+12,240,578,10,5780,1156,2,10404,11560
1.00E+12,310,1879,12.7,14800,1879,1,12921,14800
1.00E+12,310,159,16.2,980,159,1,821,980
1.00E+12,310,195,16.3,1200,390,2,2010,2400
1.00E+12,240,730,16.3,4480,730,1,3750,4480
1.00E+12,300,744,30,2480,2976,4,6944,9920
7703166,310,369,7,5280,738,2,9822,10560
1.00E+12,310,1575,7,22500,1575,1,20925,22500
2.10E+12,310,268,9,2980,268,1,2712,2980
1.00E+12,310,351,9,3900,351,1,3549,3900
1.00E+12,310,1352,54.5,2480,5407,4,4513,9920
2.10E+12,310,539,9,5980,539,1,5441,5980
2.10E+12,310,629,9,6980,1258,2,12702,13960
1.00E+12,200,6630,17,39000,6630,1,32370,39000
,,,,,,,,
90307,200,15300,10,153000,15300,1,137700,153000
1.00E+12,200,7020,18,39000,7020,1,31980,39000
1.00E+12,200,5000,10,50000,5000,1,45000,50000
2.10E+12,310,540,10,5400,1080,2,9720,10800
1.00E+12,500,9510,21.1,45000,9510,1,35490,45000
1.00E+12,310,828,9.7,8500,828,1,7672,8500
1.00E+12,310,1315,9.7,13500,1315,1,12185,13500
1.00E+12,310,1098,10,10980,1098,1,9882,10980
7632909,310,252,7,3600,756,3,10044,10800
1.00E+12,310,256,11.6,2200,3840,15,29160,33000
1.00E+12,200,256,11.6,2200,3840,15,29160,33000
1.00E+12,200,1382,10.7,12900,1382,1,11518,12900
1.00E+12,200,1450,5,29000,1450,1,27550,29000
1.00E+12,200,6120,18,34000,6120,1,27880,34000
2.10E+12,240,2003,33.5,5980,8012,4,15908,23920
1.00E+12,200,2850,6,47500,2850,1,44650,47500
6609534,310,173,7,2480,173,1,2307,2480
8118029,310,252,7,3600,504,2,6696,7200
1.00E+12,601,199,5,3980,199,1,3781,3980
1.00E+12,200,9317,17.1,54600,9317,1,45283,54600
1.00E+12,601,812,14.5,5600,812,1,4788,5600
1.00E+12,240,1470,35,4200,2940,2,5460,8400
1.00E+12,310,898,10,8980,898,1,8082,8980
1.00E+12,200,1116,4,27900,1116,1,26784,27900
1.00E+12,100,495,5,9900,495,1,9405,9900
1.00E+12,100,298,10,2980,298,1,2682,2980
1.00E+12,310,156,7.9,1980,156,1,1824,1980
1.00E+12,200,2900,20,14500,2900,1,11600,14500
1.00E+12,310,124,10,1240,1364,11,12276,13640
8986888,310,435,9.7,4500,435,1,4065,4500
1.00E+12,310,241,9.6,2500,241,1,2259,2500
1.00E+12,310,367,9.7,3800,367,1,3433,3800
1.00E+12,310,115,5,2300,115,1,2185,2300
7934427,310,320,7,4580,320,1,4260,4580
1.00E+12,200,3132,9,34800,3132,1,31668,34800
1.00E+12,200,6240,20,31200,6240,1,24960,31200
1.00E+12,205,3046,25.6,11900,3046,1,8854,11900
1.00E+12,310,890,10,8900,1780,2,16020,17800
2.10E+12,310,400,10,4000,400,1,3600,4000
1.00E+12,500,17325,19.3,90000,17325,1,72675,90000
1.00E+12,310,280,9.4,2980,280,1,2700,2980
1.00E+12,310,280,9.4,2980,280,1,2700,2980
1.00E+12,310,186,9.4,1980,559,3,5381,5940
1.00E+12,310,4937,27.6,17900,4937,1,12963,17900
1.00E+12,310,339,9.4,3600,678,2,6522,7200
1.00E+12,205,4937,27.6,17900,4937,1,12963,17900
1.00E+12,310,1323,7,18900,1323,1,17577,18900
1.00E+12,310,693,7,9900,1386,2,18414,19800
1.00E+12,310,3420,10,34200,3420,1,30780,34200
2.10E+12,310,240,10,2400,240,1,2160,2400
1.00E+12,200,8900,10,89000,8900,1,80100,89000
1.00E+12,310,156,7.2,2180,156,1,2024,2180
1.00E+12,310,429,7.2,5980,429,1,5551,5980
1.00E+12,310,390,10,3900,390,1,3510,3900
1.00E+12,240,13444,39.9,33700,26887,2,40513,67400
2.10E+12,200,578,10,5780,578,1,5202,5780
1.00E+12,310,690,10,6900,4140,6,37260,41400
1.00E+12,310,77,7.8,990,77,1,913,990
7628565,310,306,7.9,3880,306,1,3574,3880
1.00E+12,100,100,7.8,1280,100,1,1180,1280
1.00E+12,501,267,7.9,3380,267,1,3113,3380
1.00E+12,100,1129,11.8,9580,1129,1,8451,9580
1.00E+12,200,970,14.9,6500,970,1,5530,6500
1.00E+12,200,5880,15,39200,5880,1,33320,39200
1.00E+12,310,398,10,3980,1194,3,10746,11940
2.10E+12,310,648,9.3,6980,648,1,6332,6980
6609544,310,239,9.3,2580,239,1,2341,2580
1.00E+12,310,438,10,4380,876,2,7884,8760
1.00E+12,200,12720,24,53000,12720,1,40280,53000
1.00E+12,310,49,4.9,990,490,10,9410,9900
1.00E+12,500,3147,5.9,52900,3147,1,49753,52900
1.00E+12,310,598,10,5980,2392,4,21528,23920
1.00E+12,310,330,10,3300,330,1,2970,3300
1.00E+12,511,2888,38,7600,8664,3,14136,22800
8288975,310,878,10,8780,1756,2,15804,17560
1.00E+12,310,648,10,6480,1944,3,17496,19440
1.00E+12,240,1326,19,6980,1326,1,5654,6980
6615474,310,251,9.8,2560,251,1,2309,2560
6609544,310,254,9.8,2580,507,2,4653,5160
1.00E+12,310,540,9.8,5500,540,1,4960,5500
2868309,200,10884,7.8,139000,10884,1,128116,139000
1.00E+12,200,1796,20,8980,5388,3,21552,26940
2.10E+12,310,1442,9.1,15800,8652,6,86148,94800
2.10E+12,310,438,9.1,4800,1314,3,13086,14400
1.00E+12,205,2640,30,8800,2640,1,6160,8800
1.00E+12,200,269,1,26900,538,2,53262,53800
1.00E+12,500,4738,17.5,27000,9476,2,44524,54000
1.00E+12,100,2242,11.8,19000,2242,1,16758,19000
9054187,310,194,7,2780,1358,7,18102,19460
1.00E+12,310,209,7.5,2780,209,1,2571,2780
1.00E+12,310,898,7.5,11900,898,1,11002,11900
1.00E+12,310,300,7.5,3980,300,1,3680,3980
1.00E+12,310,345,7.5,4580,690,2,8470,9160
1.00E+12,200,5264,16,32900,5264,1,27636,32900
9069411,100,63,2,3150,63,1,3087,3150
1.00E+12,310,50,5,1000,50,1,950,1000
1.00E+12,310,50,5,1000,400,8,7600,8000
1.00E+12,310,588,14.8,3980,1765,3,10175,11940
1.00E+12,200,590,10,5900,1180,2,10620,11800
1.00E+12,200,6545,19.3,34000,6545,1,27455,34000
2.10E+12,205,956,20,4780,956,1,3824,4780
1.00E+12,310,7145,23.1,30900,28581,4,95019,123600
1.00E+12,310,357,14.6,2450,357,1,2093,2450
2.10E+12,310,536,9,5980,1072,2,10888,11960
2.10E+12,200,11293,22.6,49900,11293,1,38607,49900
7241898,310,848,10,8480,848,1,7632,8480
1.00E+12,310,988,9.9,9980,988,1,8992,9980
1.00E+12,310,348,10,3480,696,2,6264,6960
1.00E+12,310,534,17.9,2980,534,1,2446,2980
1.00E+12,501,13651,40.2,34000,13651,1,20349,34000
1.00E+12,310,418,7,5980,1254,3,16686,17940
1.00E+12,200,1550,10,15500,1550,1,13950,15500
8039735,310,209,10,2100,209,1,1891,2100
8824761,310,280,10,2800,280,1,2520,2800
1.00E+12,100,353,22.1,1600,1059,3,3741,4800
1.00E+12,310,138,7,1980,138,1,1842,1980
10529379,310,475,9.5,4980,475,1,4505,4980
1.00E+12,310,808,9.5,8480,808,1,7672,8480
1.00E+12,310,129,5,2580,129,1,2451,2580
7299217,310,545,5,10900,545,1,10355,10900
2.10E+12,310,138,7,1980,138,1,1842,1980
1.00E+12,310,2767,17.9,15500,2767,1,12733,15500
1.00E+12,310,171,8.6,1980,342,2,3618,3960
1.00E+12,310,258,8.6,2980,515,2,5445,5960
1.00E+12,310,179,5,3580,179,1,3401,3580
1.00E+12,200,400,4,10000,800,2,19200,20000
6610623,511,1633,33.3,4900,4900,3,9800,14700
1.00E+12,310,342,9.8,3480,342,1,3138,3480
1.00E+12,310,298,10,2980,298,1,2682,2980
7298642,310,668,10,6680,1336,2,12024,13360
6835815,310,151,7.6,1980,302,2,3658,3960
7095596,310,182,7.6,2390,364,2,4416,4780
1.00E+12,200,2119,16.3,13000,2119,1,10881,13000
1.00E+12,205,7550,37.4,20200,15100,2,25300,40400
1.00E+12,200,1473,11.4,12900,1473,1,11427,12900
1.00E+12,310,1650,11.8,13980,1650,1,12330,13980
1.00E+12,310,516,11.8,4380,516,1,3864,4380
1.00E+12,205,6900,30,23000,6900,1,16100,23000
1.00E+12,310,250,10,2500,250,1,2250,2500
1.00E+12,310,698,10,6980,4188,6,37692,41880
2.10E+12,310,414,5,8280,1242,3,23598,24840
7712617,340,359,6.9,5200,359,1,4841,5200
6609352,310,159,5,3180,159,1,3021,3180
7480109,310,105,7,1500,210,2,2790,3000
10016443,100,104,5,2080,104,1,1976,2080
2.10E+12,310,559,3.5,15800,559,1,15241,15800
2.10E+12,310,208,3.5,5900,208,1,5692,5900
2.10E+12,310,105,3.5,2980,105,1,2875,2980
1.00E+12,310,303,3.5,8580,303,1,8277,8580
8633953,310,509,3.5,14400,509,1,13891,14400
1.00E+12,310,423,3.5,11980,423,1,11557,11980
1.00E+12,300,11950,23,52000,11950,1,40050,52000
1.00E+12,200,5710,20.9,27300,5710,1,21590,27300
1.00E+12,300,33980,19.1,178000,67960,2,288040,356000
1.00E+12,310,428,10,4280,428,1,3852,4280
2037011,300,5655,14.5,39000,5655,1,33345,39000
1.00E+12,310,343,9.6,3580,343,1,3237,3580
1.00E+12,310,287,9.6,2990,287,1,2703,2990
2.10E+12,205,1226,28,4380,2452,2,6308,8760
2.10E+12,100,2079,26.3,7900,2079,1,5821,7900
7509462,601,855,14.5,5900,855,1,5045,5900
1.00E+12,310,1190,10,11900,1190,1,10710,11900
1.00E+12,310,256,11.7,2180,256,1,1924,2180
1.00E+12,310,79,11.6,680,79,1,601,680
1.00E+12,310,1011,11.8,8580,1011,1,7569,8580
7936136,100,1438,20.6,6980,1438,1,5542,6980
1.00E+12,100,256,11.7,2180,256,1,1924,2180
1.00E+12,100,79,11.6,680,79,1,601,680
1.00E+12,100,542,11.8,4600,542,1,4058,4600
1.00E+12,100,91,11.7,780,455,5,3445,3900
1.00E+12,205,6000,30.2,19900,18000,3,41700,59700
1.00E+12,200,12000,30.2,39800,24000,2,55600,79600
1.00E+12,310,398,10,3980,398,1,3582,3980
1.00E+12,200,3270,15,21800,3270,1,18530,21800
1.00E+12,205,8693,99,8780,130395,15,1305,131700
1.00E+12,205,2300,33.3,6900,16100,7,32200,48300
1.00E+12,200,47900,10,479000,47900,1,431100,479000
1.00E+12,200,13080,15,87200,13080,1,74120,87200
7095585,340,498,10,4980,1494,3,13446,14940
1.00E+12,340,428,10,4280,1284,3,11556,12840
2.10E+12,310,60,5,1200,120,2,2280,2400
6617425,310,249,5,4980,249,1,4731,4980
1.00E+12,310,798,10,7980,798,1,7182,7980
1.00E+12,200,2392,14.5,16500,7176,3,42324,49500
6977207,310,818,46,1780,1636,2,1924,3560
1.00E+12,310,1048,10,10480,1048,1,9432,10480
1.00E+12,200,5398,16.3,33120,5398,1,27722,33120
1.00E+12,310,2734,9.8,27980,2734,1,25246,27980
1.00E+12,310,3225,9.8,32980,3225,1,29755,32980
1.00E+12,310,584,9.8,5980,584,1,5396,5980
1.00E+12,200,17680,17.7,100000,17680,1,82320,100000
2.10E+12,310,1390,10,13900,1390,1,12510,13900
1.00E+12,310,98,10,980,98,1,882,980
8562095,300,37,1,3780,37,1,3743,3780
6871988,300,28,1,2800,28,1,2772,2800
1.00E+12,200,15900,61.4,25900,15900,1,10000,25900
1.00E+12,200,4315,24,17980,8630,2,27330,35960
1.00E+12,205,768,25.6,3000,1536,2,4464,6000
1.00E+12,200,3600,18,20000,3600,1,16400,20000
1.00E+12,310,1796,14.3,12600,1796,1,10804,12600
1.00E+12,601,347,5,6950,347,1,6603,6950
1.00E+12,240,800,7.5,10700,800,1,9900,10700
8333610,310,326,7.8,4200,326,1,3874,4200
1.00E+12,310,550,7.9,6980,1099,2,12861,13960
2.10E+12,310,989,12.4,7980,989,1,6991,7980
2.10E+12,310,3485,24.9,13980,3485,1,10495,13980
8306213,310,800,10,8000,4000,5,36000,40000
1.00E+12,310,198,10,1980,1188,6,10692,11880
1.00E+12,310,948,19,4980,3792,4,16128,19920
9704383,310,2027,8.8,22980,2027,1,20953,22980
1.00E+12,310,3734,53.5,6980,22404,6,19476,41880
1.00E+12,310,96,7,1380,288,3,3852,4140
1.00E+12,200,2000,5,40000,2000,1,38000,40000
1.00E+12,200,6290,18.5,34000,6290,1,27710,34000
1.00E+12,310,124,8.8,1410,124,1,1286,1410
1.00E+12,601,79,5,1580,79,1,1501,1580
1.00E+12,511,6095,51.2,11900,12189,2,11611,23800
1.00E+12,310,313,2.4,12900,313,1,12587,12900
1.00E+12,310,116,2.4,4780,116,1,4664,4780
1.00E+12,310,26,2.4,1080,26,1,1054,1080
7695432,310,38,2.4,1600,38,1,1562,1600
1.00E+12,310,121,2.4,4980,121,1,4859,4980
1.00E+12,310,96,2.4,3980,96,1,3884,3980
1.00E+12,310,218,2.4,8980,218,1,8762,8980
1.00E+12,310,96,2.4,3980,96,1,3884,3980
9584368,310,96,2.4,3980,96,1,3884,3980
1.00E+12,310,23,2.4,950,92,4,3708,3800
1.00E+12,310,72,2.4,2980,72,1,2908,2980
9701616,310,705,8.8,7980,705,1,7275,7980
2.10E+12,310,166,8.8,1880,332,2,3428,3760
1.00E+12,500,9570,19.2,49900,9570,1,40330,49900
8077493,310,197,9.2,2150,197,1,1953,2150
6609543,310,209,9.2,2280,209,1,2071,2280
6616190,310,365,9.2,3980,365,1,3615,3980
1.00E+12,310,778,9.2,8480,778,1,7702,8480
1.00E+12,200,143,13,1100,1430,10,9570,11000
1.00E+12,310,8096,25.3,32000,16192,2,47808,64000
1.00E+12,310,973,7,13900,2919,3,38781,41700
1.00E+12,310,2320,10,23200,2320,1,20880,23200
1.00E+12,310,968,10,9680,1936,2,17424,19360
2.10E+12,310,1332,25.2,5280,1332,1,3948,5280
2.10E+12,310,2044,25.2,8100,2044,1,6056,8100
1.00E+12,310,90,6.5,1380,90,1,1290,1380
1.00E+12,310,110,6.5,1680,110,1,1570,1680
2.10E+12,200,4670,33.6,13900,4670,1,9230,13900
2.10E+12,340,397,7,5680,397,1,5283,5680
1.00E+12,310,59,5,1180,354,6,6726,7080
2.10E+12,310,75,5,1500,1800,24,34200,36000
1.00E+12,500,2803,16.3,17200,2803,1,14397,17200
1.00E+12,200,525,15,3500,2100,4,11900,14000
1.00E+12,200,3480,16.7,20900,3480,1,17420,20900
1.00E+12,340,167,7,2390,334,2,4446,4780
1.00E+12,310,755,6.9,10980,755,1,10225,10980
1.00E+12,310,755,6.9,10980,755,1,10225,10980
1.00E+12,310,848,10,8480,848,1,7632,8480
1.00E+12,310,1198,10,11980,1198,1,10782,11980
1.00E+12,240,2407,41.5,5800,4814,2,6786,11600
7896436,310,348,10,3480,348,1,3132,3480
1.00E+12,310,1658,10,16580,1658,1,14922,16580
1.00E+12,310,5187,19,27300,10374,2,44226,54600
1.00E+12,340,681,13.8,4950,681,1,4269,4950
7509420,310,225,5,4500,450,2,8550,9000
1.00E+12,310,107,5,2150,107,1,2043,2150
1.00E+12,310,7168,25.6,28000,7168,1,20832,28000
,,,,,,,,
,,,,,,,,
8593571,310,272,5,5450,1904,7,36246,38150
1.00E+12,310,998,10,9980,998,1,8982,9980
8083277,601,482,9.7,4950,482,1,4468,4950
8083275,310,482,9.7,4950,482,1,4468,4950
7419878,310,360,9,3980,720,2,7240,7960
1.00E+12,310,896,9.1,9900,3584,4,36016,39600
1.00E+12,310,274,5,5480,1096,4,20824,21920
1.00E+12,310,89,5,1780,178,2,3382,3560
1.00E+12,310,136,6.9,1980,136,1,1844,1980
7069657,310,301,6.9,4380,301,1,4079,4380
1.00E+12,310,60,6.8,880,60,1,820,880
1.00E+12,100,752,6.9,10900,752,1,10148,10900
1.00E+12,100,253,6.9,3680,253,1,3427,3680
7050044,100,205,6.9,2980,205,1,2775,2980
1.00E+12,100,60,6.8,880,60,1,820,880
1.00E+12,310,1533,9,16980,1533,1,15447,16980
1.00E+12,310,4425,9,48980,4425,1,44555,48980
1.00E+12,100,199,5,3990,199,1,3791,3990
1.00E+12,310,149,5,2980,298,2,5662,5960
1.00E+12,310,3927,52.5,7480,47124,12,42636,89760
1.00E+12,511,3927,52.5,7480,15708,4,14212,29920
1.00E+12,310,590,11.8,5000,590,1,4410,5000
7150833,601,580,11.6,4990,580,1,4410,4990
2.10E+12,310,1868,28.7,6500,3736,2,9264,13000
1.00E+12,310,252,7,3600,756,3,10044,10800
2.10E+12,200,5994,30,19980,11988,2,27972,39960
1.00E+12,200,600,5,12000,600,1,11400,12000
2.10E+12,200,50000,38.8,129000,50000,1,79000,129000
1.00E+12,310,383,7,5480,766,2,10194,10960
1.00E+12,310,768,7,10980,768,1,10212,10980
8986773,310,143,8,1780,143,1,1637,1780
1.00E+12,310,938,10,9380,938,1,8442,9380
2.10E+12,310,495,5,9900,495,1,9405,9900
1.00E+12,200,18500,5,370000,18500,1,351500,370000
1.00E+12,200,2600,24.8,10500,2600,1,7900,10500
1.00E+12,310,99,5,1990,396,4,7564,7960
8333598,310,149,5,2980,149,1,2831,2980
1.00E+12,310,199,5,3980,199,1,3781,3980
1.00E+12,310,678,10,6780,2034,3,18306,20340
1.00E+12,310,760,19,4000,1520,2,6480,8000
1.00E+12,240,760,19,4000,1520,2,6480,8000
1.00E+12,240,1700,10,17000,1700,1,15300,17000
1.00E+12,240,315,10,3150,1575,5,14175,15750
1.00E+12,310,6792,16.2,42000,6792,1,35208,42000
1.00E+12,310,3610,19,19000,3610,1,15390,19000
1.00E+12,200,3610,19,19000,3610,1,15390,19000
1.00E+12,200,10182,5.9,172000,10182,1,161818,172000
1.00E+12,200,1500,3,50000,1500,1,48500,50000
8315731,310,220,7.9,2780,220,1,2560,2780
7712800,310,442,11.6,3800,442,1,3358,3800
6611123,100,648,16.3,3980,648,1,3332,3980
1.00E+12,100,405,11.6,3480,405,1,3075,3480
1.00E+12,205,8000,40,20000,16000,2,24000,40000
1.00E+12,310,495,5,9900,990,2,18810,19800
1.00E+12,310,1695,5,33900,3390,2,64410,67800
1.00E+12,310,1290,10,12900,2580,2,23220,25800
1.00E+12,500,15405,26.2,58800,15405,1,43395,58800
1.00E+12,310,490,14.5,3380,490,1,2890,3380
1.00E+12,310,698,7,9980,698,1,9282,9980
1.00E+12,310,327,7,4680,981,3,13059,14040
1.00E+12,310,99,5,1980,198,2,3762,3960
1.00E+12,310,310,8.9,3480,310,1,3170,3480
2.10E+12,310,592,9.9,5980,592,1,5388,5980
2.10E+12,310,275,9.9,2780,275,1,2505,2780
2.10E+12,310,3558,18.9,18800,7116,2,30484,37600
1.00E+12,200,142,5,2850,1420,10,27080,28500
1.00E+12,310,998,10,9980,998,1,8982,9980
1.00E+12,100,243,14.5,1680,486,2,2874,3360
1.00E+12,310,452,19,2380,452,1,1928,2380
7078506,310,1231,19,6480,1231,1,5249,6480
1.00E+12,310,623,19,3280,623,1,2657,3280
1.00E+12,200,121230,13.6,891400,363690,3,2310510,2674200
1.00E+12,310,1267,9.7,13000,1267,1,11733,13000
1.00E+12,500,2388,9.7,24500,2388,1,22112,24500
1.00E+12,500,7436,20.7,36000,7436,1,28564,36000
2.10E+12,310,1250,37,3380,1250,1,2130,3380
2.10E+12,205,2590,32.8,7900,2590,1,5310,7900
7531299,310,418,10,4180,418,1,3762,4180
1.00E+12,310,1450,10,14500,1450,1,13050,14500
1.00E+12,500,3518,18.5,19000,3518,1,15482,19000
2.10E+12,200,1753,25.6,6850,3506,2,10194,13700
,,,,,,,,
1.00E+12,200,6287,12.6,49900,6287,1,43613,49900
1.00E+12,310,11374,28.4,40000,11374,1,28626,40000
1.00E+12,200,15616,24.4,64000,15616,1,48384,64000
1.00E+12,310,553,7,7900,553,1,7347,7900
1.00E+12,310,280,7,4000,280,1,3720,4000
1.00E+12,200,15199,20.3,75000,15199,1,59801,75000
1.00E+12,310,407,7.1,5700,814,2,10586,11400
6617166,310,320,16.2,1980,320,1,1660,1980
8333620,310,430,11.8,3650,430,1,3220,3650
1.00E+12,310,1746,11.8,14800,1746,1,13054,14800
1.00E+12,100,613,11.8,5200,613,1,4587,5200
1.00E+12,100,256,11.7,2180,256,1,1924,2180
6611192,310,140,7,2000,140,1,1860,2000
2.10E+12,310,47,6.9,680,47,1,633,680
1.00E+12,310,70,7,1000,700,10,9300,10000
1.00E+12,200,12167,18.2,67000,12167,1,54833,67000
1.00E+12,240,70,5,1400,70,1,1330,1400
2.10E+12,310,98,6.2,1580,196,2,2964,3160
8865243,310,784,6.2,12600,784,1,11816,12600
2.10E+12,310,716,6.2,11500,716,1,10784,11500
2.10E+12,310,1061,6.3,16800,1061,1,15739,16800
2.10E+12,310,1435,14.5,9900,4305,3,25395,29700
1.00E+12,310,159,7,2280,1431,9,19089,20520
8117962,310,2197,16.3,13480,2197,1,11283,13480
8218669,100,1952,16.3,11980,3904,2,20056,23960
1.00E+12,100,387,16.3,2380,387,1,1993,2380
2.10E+12,200,687,20.9,3280,1374,2,5186,6560
1.00E+12,310,798,10,7980,7182,9,64638,71820
1.00E+12,240,561,15.6,3600,3368,6,18232,21600
2.10E+12,310,1932,28,6900,1932,1,4968,6900
1.00E+12,310,700,23.5,2980,1400,2,4560,5960
2.10E+12,200,1932,28,6900,1932,1,4968,6900
1.00E+12,310,290,5,5800,290,1,5510,5800
1.00E+12,310,298,10,2980,298,1,2682,2980
1.00E+12,310,298,10,2980,596,2,5364,5960
8937280,310,158,10,1580,158,1,1422,1580
1.00E+12,310,1990,10,19900,1990,1,17910,19900
1.00E+12,310,198,10,1980,198,1,1782,1980
1.00E+12,310,388,10,3880,776,2,6984,7760
2.10E+12,310,149,5,2980,1341,9,25479,26820
1.00E+12,340,429,4.3,9900,429,1,9471,9900
2.10E+12,310,698,10,6980,1396,2,12564,13960
1.00E+12,200,13366,16.3,82000,13366,1,68634,82000
1.00E+12,500,632,8,7900,1896,3,21804,23700
1.00E+12,310,1900,10,19000,1900,1,17100,19000
1.00E+12,310,348,7,4980,1044,3,13896,14940
1.00E+12,310,152,7,2180,608,4,8112,8720
1.00E+12,310,79,5,1580,158,2,3002,3160
1.00E+12,100,274,5,5480,1096,4,20824,21920
8549264,601,212,5,4250,212,1,4038,4250
8085635,310,586,6.1,9680,586,1,9094,9680
7710017,310,604,6.1,9980,604,1,9376,9980
1.00E+12,310,151,6,2500,151,1,2349,2500
2.10E+12,310,957,27.5,3480,1914,2,5046,6960
,,,,,,,,
7460619,310,358,10,3580,358,1,3222,3580
2.10E+12,601,2448,61.5,3980,2448,1,1532,3980
1.00E+12,601,930,42.3,2200,930,1,1270,2200
1.00E+12,601,930,42.3,2200,930,1,1270,2200
1.00E+12,100,930,42.3,2200,1860,2,2540,4400
1.00E+12,100,930,42.3,2200,930,1,1270,2200
2.10E+12,310,488,7,6980,488,1,6492,6980
2.10E+12,310,2169,24.9,8725,2169,1,6556,8725
1.00E+12,310,181,6.1,2980,181,1,2799,2980
1.00E+12,310,273,6.1,4500,273,1,4227,4500
8123147,310,349,5,6980,349,1,6631,6980
8040010,240,1932,46,4200,1932,1,2268,4200
1.00E+12,310,3498,35.8,9780,3498,1,6282,9780
1.00E+12,310,598,10,5980,1794,3,16146,17940
1.00E+12,310,141,8.9,1580,141,1,1439,1580
1.00E+12,340,313,7,4480,313,1,4167,4480
6610189,340,65,6.9,940,260,4,3500,3760
1.00E+12,340,208,7,2980,208,1,2772,2980
1.00E+12,200,612,4,15300,612,1,14688,15300
1.00E+12,200,252,4,6300,504,2,12096,12600
1.00E+12,310,157,7,2250,471,3,6279,6750
1.00E+12,310,698,7,9980,698,1,9282,9980
1.00E+12,200,36477,8.2,445000,36477,1,408523,445000
7234772,310,527,10,5280,527,1,4753,5280
8839959,310,78,7,1120,1014,13,13546,14560
1.00E+12,200,16146,17.6,92000,16146,1,75854,92000
1.00E+12,310,49,4.9,990,245,5,4705,4950
1.00E+12,310,149,5,2980,298,2,5662,5960
9750424,310,299,5,5980,299,1,5681,5980
1.00E+12,100,3540,11.8,30000,35400,10,264600,300000
1.00E+12,240,452,16.3,2780,904,2,4656,5560
1.00E+12,310,676,38,1780,2027,3,3313,5340
9069295,310,416,7,5980,416,1,5564,5980
7095585,310,346,6.9,4980,346,1,4634,4980
2.10E+12,200,4388,19.2,22800,4388,1,18412,22800
1.00E+12,240,764,40.2,1900,764,1,1136,1900
1.00E+12,310,282,8.1,3500,282,1,3218,3500
1.00E+12,310,920,10,9200,2760,3,24840,27600
1.00E+12,310,439,7,6280,439,1,5841,6280
1.00E+12,310,376,7,5380,1128,3,15012,16140
6615596,310,320,7,4580,2240,7,29820,32060
1.00E+12,310,348,7,4980,348,1,4632,4980
8058811,310,441,7,6300,441,1,5859,6300
1.00E+12,340,1858,31.1,5980,1858,1,4122,5980
1.00E+12,200,4107,16.4,25000,8214,2,41786,50000
1.00E+12,310,82,6.9,1180,164,2,2196,2360
1.00E+12,240,4392,40.3,10900,13175,3,19525,32700
1.00E+12,310,27900,15.6,179000,27900,1,151100,179000
2.10E+12,310,1480,10,14800,5920,4,53280,59200
7672295,310,532,7.8,6780,532,1,6248,6780
1.00E+12,511,3972,53.1,7480,7943,2,7017,14960
1.00E+12,340,3972,53.1,7480,7943,2,7017,14960
2.10E+12,310,295,5,5900,885,3,16815,17700
6889898,310,273,7,3900,546,2,7254,7800
1.00E+12,310,348,7,4980,348,1,4632,4980
10627394,310,492,11.8,4180,492,1,3688,4180
7335636,310,259,11.8,2200,259,1,1941,2200
1.00E+12,310,300,11.8,2550,300,1,2250,2550
1.00E+12,310,578,11.8,4900,578,1,4322,4900
1.00E+12,100,141,11.8,1200,141,1,1059,1200
1.00E+12,100,253,11.8,2150,253,1,1897,2150
1.00E+12,100,578,11.8,4900,578,1,4322,4900
7695735,100,115,11.7,980,230,2,1730,1960
7695649,100,116,11.7,990,348,3,2622,2970
1.00E+12,501,941,11.8,7980,941,1,7039,7980
1.00E+12,501,141,11.8,1200,141,1,1059,1200
1.00E+12,200,3600,24,15000,7200,2,22800,30000
1.00E+12,310,244,4.1,5900,244,1,5656,5900
1.00E+12,310,165,4.1,3980,165,1,3815,3980
1.00E+12,310,349,8.8,3980,1394,4,14526,15920
2.10E+12,310,882,19.2,4590,882,1,3708,4590
2.10E+12,310,113,6.8,1650,225,2,3075,3300
1.00E+12,310,183,6.8,2680,183,1,2497,2680
1.00E+12,310,164,5,3280,164,1,3116,3280
1.00E+12,310,84,5,1680,336,4,6384,6720
8602158,310,232,5,4650,928,4,17672,18600
1.00E+12,310,129,5,2580,645,5,12255,12900
1.00E+12,240,446,18,2480,446,1,2034,2480
1.00E+12,310,1288,8.1,15900,1288,1,14612,15900
7275213,310,717,18,3980,717,1,3263,3980
1.00E+12,310,711,8.9,7980,711,1,7269,7980
1.00E+12,310,398,8,4980,398,1,4582,4980
1.00E+12,100,711,8.9,7980,711,1,7269,7980
1.00E+12,501,446,18,2480,446,1,2034,2480
1.00E+12,501,107,8.9,1200,107,1,1093,1200
7690677,501,229,8.9,2580,229,1,2351,2580
1.00E+12,501,536,18,2980,536,1,2444,2980
1.00E+12,501,355,8.9,3990,355,1,3635,3990
1.00E+12,501,309,8.9,3480,309,1,3171,3480
1.00E+12,310,2664,53.5,4980,21312,8,18528,39840
1.00E+12,511,2664,53.5,4980,37296,14,32424,69720
2.10E+12,501,30,1,3000,30,1,2970,3000
1.00E+12,340,70624,23,307000,70624,1,236376,307000
1.00E+12,500,70624,23,307000,70624,1,236376,307000
1.00E+12,200,2900,10,29000,2900,1,26100,29000
1.00E+12,240,1749,29.2,5980,1749,1,4231,5980
1.00E+12,100,1820,23,7900,1820,1,6080,7900
,,,,,,,,
1.00E+12,310,440,5,8800,440,1,8360,8800
1.00E+12,100,752,4,19000,1504,2,36496,38000
1.00E+12,310,449,5,8980,449,1,8531,8980
1.00E+12,500,14110,20.4,69000,14110,1,54890,69000
,,,,,,,,
2.10E+12,200,3000,30,10000,3000,1,7000,10000
1.00E+12,310,168,8.9,1880,336,2,3424,3760
2.10E+12,310,851,9,9500,851,1,8649,9500
2.10E+12,310,186,8.9,2080,186,1,1894,2080
1.00E+12,200,13000,20,65000,13000,1,52000,65000
1.00E+12,200,710,12.9,5500,710,1,4790,5500
1.00E+12,200,2660,16.6,16000,2660,1,13340,16000
1.00E+12,310,208,7,2980,208,1,2772,2980
1.00E+12,200,186240,19.4,962000,186240,1,775760,962000
1.00E+12,310,45154,23.1,195300,45154,1,150146,195300
1.00E+12,340,833,7,11900,833,1,11067,11900
1.00E+12,340,302,7,4320,302,1,4018,4320
1.00E+12,340,302,7,4320,302,1,4018,4320
1.00E+12,200,3450,3,115000,3450,1,111550,115000
2.10E+12,310,1498,25.1,5980,1498,1,4482,5980
1.00E+12,200,1180,20,5900,3540,3,14160,17700
1.00E+12,200,1227,20.8,5900,4908,4,18692,23600
1.00E+12,205,4730,23.8,19900,4730,1,15170,19900
1.00E+12,310,291,9.8,2980,291,1,2689,2980
2.10E+12,200,1350,30,4500,1350,1,3150,4500
1.00E+12,340,138,7,1980,276,2,3684,3960
1.00E+12,310,588,8.4,6980,1175,2,12785,13960
1.00E+12,310,502,8.4,5980,502,1,5478,5980
1.00E+12,310,183,18.6,980,365,2,1595,1960
1.00E+12,310,183,18.6,980,365,2,1595,1960
6621587,100,183,18.6,980,365,2,1595,1960
1.00E+12,100,1408,14.1,9980,1408,1,8572,9980
1.00E+12,501,49,1,4980,49,1,4931,4980
7095585,100,49,1,4980,98,2,9862,9960
2.10E+12,310,128,5.3,2400,128,1,2272,2400
1.00E+12,310,122,5.4,2280,122,1,2158,2280
1.00E+12,100,3781,19,19900,3781,1,16119,19900
1.00E+12,240,946,19,4980,1892,2,8068,9960
1.00E+12,300,1048,4,26400,1048,1,25352,26400
1.00E+12,310,153,6.4,2390,153,1,2237,2390
1.00E+12,310,133,6.4,2080,266,2,3894,4160
6609224,310,136,6.4,2130,136,1,1994,2130
2.10E+12,200,1375,23,5980,1375,1,4605,5980
1.00E+12,310,16450,23.5,70000,16450,1,53550,70000
1.00E+12,340,6917,21.6,32000,6917,1,25083,32000
9527114,310,422,9.4,4480,844,2,8116,8960
1.00E+12,310,186,9.4,1980,186,1,1794,1980
1.00E+12,310,1035,9.4,10980,1035,1,9945,10980
1.00E+12,310,638,5.3,11980,638,1,11342,11980
1.00E+12,310,425,5.3,7980,850,2,15110,15960
1.00E+12,310,205,8.6,2380,205,1,2175,2380
7296003,310,93,8.6,1080,93,1,987,1080
1.00E+12,310,12925,23.5,55000,12925,1,42075,55000
1.00E+12,310,213,7.1,2990,213,1,2777,2990
1.00E+12,310,119,7.1,1680,119,1,1561,1680
1.00E+12,310,349,5,6980,349,1,6631,6980
2.10E+12,200,2305,33,6980,4610,2,9350,13960
1.00E+12,511,4950,50,9900,19800,4,19800,39600
6615248,310,212,9.2,2300,212,1,2088,2300
1.00E+12,310,1184,9.3,12800,1184,1,11616,12800
2.10E+12,310,1399,15.6,8980,1399,1,7581,8980
1.00E+12,200,1860,15,12400,1860,1,10540,12400
9527127,310,755,9.5,7980,755,1,7225,7980
1.00E+12,310,660,9.5,6980,660,1,6320,6980
1.00E+12,310,1029,9.5,10880,1029,1,9851,10880
1.00E+12,200,1840,8.1,22600,1840,1,20760,22600
2.10E+12,310,210,5,4200,210,1,3990,4200
2.10E+12,601,1711,14.5,11800,1711,1,10089,11800
1.00E+12,310,483,7,6900,483,1,6417,6900
1.00E+12,511,4388,65,6750,17550,4,9450,27000
1.00E+12,500,6366,7.8,81100,6366,1,74734,81100
1.00E+12,310,574,8.5,6780,574,1,6206,6780
1.00E+12,500,9432,19.2,49000,9432,1,39568,49000
1.00E+12,310,173,6.9,2500,520,3,6980,7500
9657365,310,276,6.9,3980,276,1,3704,3980
2.10E+12,240,2356,16.2,14500,2356,1,12144,14500
7299223,310,648,10,6480,1944,3,17496,19440
1.00E+12,310,188,10,1880,376,2,3384,3760
1.00E+12,310,450,10,4500,450,1,4050,4500
1.00E+12,200,30719,22.1,139000,30719,1,108281,139000
2.10E+12,310,424,5,8480,424,1,8056,8480
8527107,310,1177,9.8,11980,1177,1,10803,11980
1.00E+12,310,538,9.8,5480,538,1,4942,5480
7165283,310,83,8.3,1000,83,1,917,1000
2.10E+12,310,248,8.3,2980,248,1,2732,2980
1.00E+12,310,826,7,11800,2478,3,32922,35400
1.00E+12,310,201,7,2880,402,2,5358,5760
1.00E+12,310,4581,19.1,24000,4581,1,19419,24000
1.00E+12,310,248,10,2480,1984,8,17856,19840
2.10E+12,310,1889,25.3,7475,1889,1,5586,7475
7938700,310,7717,53.3,14480,15434,2,13526,28960
7938700,511,7717,53.3,14480,15434,2,13526,28960
2.10E+12,200,1889,25.3,7475,1889,1,5586,7475
2.10E+12,310,794,14.8,5380,794,1,4586,5380
1.00E+12,310,790,7.9,9980,790,1,9190,9980
2.10E+12,310,101,7.9,1280,101,1,1179,1280
1.00E+12,205,1976,20,9880,5928,3,23712,29640
1.00E+12,310,2129,53.5,3980,17032,8,14808,31840
1.00E+12,310,117,7,1680,1170,10,15630,16800
6804094,100,1136,19,5980,1136,1,4844,5980
1.00E+12,100,2796,28,9980,8388,3,21552,29940
1.00E+12,200,693,11.5,6020,693,1,5327,6020
2.10E+12,310,273,7,3900,273,1,3627,3900
1.00E+12,205,894,30,2980,894,1,2086,2980
1.00E+12,200,62700,15,418000,62700,1,355300,418000
2.10E+12,310,573,7.2,7980,573,1,7407,7980
6615168,310,242,7.2,3380,242,1,3138,3380
2.10E+12,200,6999,35,19980,6999,1,12981,19980
1.00E+12,310,998,10,9980,998,1,8982,9980
8645044,310,498,10,4980,498,1,4482,4980
1.00E+12,500,4176,14.5,28800,12528,3,73872,86400
1.00E+12,310,99,5,1980,99,1,1881,1980
6609550,601,92,9.7,950,184,2,1716,1900
1.00E+12,200,4446,19,23400,4446,1,18954,23400
1.00E+12,500,4446,19,23400,4446,1,18954,23400
1.00E+12,310,68,6.9,980,272,4,3648,3920
8462693,310,96,7,1380,96,1,1284,1380
2.10E+12,310,643,10,6430,1929,3,17361,19290
2.10E+12,310,208,7,2980,416,2,5544,5960
1.00E+12,310,313,7,4480,626,2,8334,8960
2.10E+12,310,131,7,1880,262,2,3498,3760
2.10E+12,310,208,10,2080,832,4,7488,8320
2.10E+12,200,8291,41.5,19980,82910,10,116890,199800
6618917,310,998,10,9980,998,1,8982,9980
1.00E+12,310,68,6.9,980,1224,18,16416,17640
1.00E+12,310,1098,10,10980,6588,6,59292,65880
1.00E+12,310,265,5.3,4980,530,2,9430,9960
1.00E+12,310,638,5.3,11980,638,1,11342,11980
1.00E+12,310,425,5.3,7980,425,1,7555,7980
2.10E+12,310,477,19.2,2480,477,1,2003,2480
7480110,310,150,10,1500,450,3,4050,4500
1.00E+12,310,578,9.7,5980,578,1,5402,5980
7922209,310,288,9.7,2980,288,1,2692,2980
2.10E+12,310,1937,9.7,19980,1937,1,18043,19980
8624384,310,423,9.7,4380,423,1,3957,4380
1.00E+12,310,1255,9.7,12980,1255,1,11725,12980
6820123,310,304,9.7,3150,304,1,2846,3150
6610105,310,670,10,6700,2010,3,18090,20100
1.00E+12,310,335,10,3350,335,1,3015,3350
1.00E+12,310,74,5,1480,74,1,1406,1480
1.00E+12,100,4317,17.1,25200,4317,1,20883,25200
1.00E+12,300,2678,15.8,16900,2678,1,14222,16900
1.00E+12,200,7182,18,39900,7182,1,32718,39900
1.00E+12,200,5127,24.4,21000,5127,1,15873,21000
1.00E+12,100,18165,52.5,34600,18165,1,16435,34600
1.00E+12,200,18770,19.4,97000,18770,1,78230,97000
8843453,310,918,10,9180,918,1,8262,9180
8703172,310,790,10,7900,790,1,7110,7900
1.00E+12,310,1628,9.6,16900,3256,2,30544,33800
1.00E+12,200,48390,20.9,231000,48390,1,182610,231000
1.00E+12,310,1050,9.7,10800,1050,1,9750,10800
1.00E+12,200,9610,16.3,59000,19220,2,98780,118000
1.00E+12,300,6890,23,30000,6890,1,23110,30000
7695348,310,92,5,1850,92,1,1758,1850
8937157,310,593,7,8480,2372,4,31548,33920
1.00E+12,310,419,7.5,5580,419,1,5161,5580
1.00E+12,310,344,7.5,4580,344,1,4236,4580
2.10E+12,310,111,7.5,1480,111,1,1369,1480
1.00E+12,310,149,7.5,1980,297,2,3663,3960
2.10E+12,310,925,5,18500,2775,3,52725,55500
7024783,310,2207,7.7,28800,2207,1,26593,28800
1.00E+12,310,1977,7.7,25800,1977,1,23823,25800
1.00E+12,310,904,7.7,11800,904,1,10896,11800
1.00E+12,100,249,5,4980,249,1,4731,4980
8956834,310,208,7,2980,624,3,8316,8940
,,,,,,,,
1.00E+12,310,714,5,14280,714,1,13566,14280
2.10E+12,310,187,9.9,1880,374,2,3386,3760
2.10E+12,310,985,9.9,9900,985,1,8915,9900
2.10E+12,310,167,9.9,1680,167,1,1513,1680
1.00E+12,310,890,10,8900,890,1,8010,8900
1.00E+12,310,345,5,6900,345,1,6555,6900
6609062,601,145,14.5,1000,145,1,855,1000
7073987,310,246,14.5,1700,246,1,1454,1700
1.00E+12,310,432,14.5,2980,432,1,2548,2980
7619380,310,980,10,9800,980,1,8820,9800
1.00E+12,310,248,10,2480,496,2,4464,4960
8323425,310,275,7,3930,275,1,3655,3930
1.00E+12,601,184,5,3680,184,1,3496,3680
1.00E+12,500,48181,25.4,190000,48181,1,141819,190000
1.00E+12,310,1770,19.9,8880,1770,1,7110,8880
1.00E+12,200,652,1,65200,652,1,64548,65200
1.00E+12,200,1218,9.7,12500,9744,8,90256,100000
1.00E+12,310,593,7,8480,593,1,7887,8480
8798086,310,176,4.9,3580,529,3,10211,10740
1.00E+12,310,623,8.9,6980,623,1,6357,6980
1.00E+12,310,436,8.9,4880,436,1,4444,4880
7687380,310,149,5,2980,149,1,2831,2980
1.00E+12,310,5297,53.5,9900,52965,10,46035,99000
2.10E+12,310,645,5,12900,645,1,12255,12900
1.00E+12,200,9494,15.8,59900,9494,1,50406,59900
7723079,310,590,10,5900,590,1,5310,5900
1.00E+12,310,735,7,10500,1470,2,19530,21000
1.00E+12,310,24950,8.3,299000,24950,1,274050,299000
1.00E+12,340,334,7,4780,334,1,4446,4780
1.00E+12,200,950,10,9500,1900,2,17100,19000
1.00E+12,240,5434,55,9880,21736,4,17784,39520
1.00E+12,310,100,5.1,1980,100,1,1880,1980
1.00E+12,200,16660,10,166600,16660,1,149940,166600
1.00E+12,340,138,7,1980,138,1,1842,1980
1.00E+12,340,71,7,1020,71,1,949,1020
1.00E+12,200,2232,9.7,22900,2232,1,20668,22900
1.00E+12,500,19680,22.1,89100,19680,1,69420,89100
1.00E+12,200,3600,18,20000,7200,2,32800,40000
1.00E+12,200,2434,11.6,20900,2434,1,18466,20900
7695376,310,180,5,3600,360,2,6840,7200
1.00E+12,310,648,10,6480,1296,2,11664,12960
2.10E+12,310,1497,27.3,5480,1497,1,3983,5480
2.10E+12,200,7276,36.4,19980,14552,2,25408,39960
1.00E+12,310,134,5,2680,268,2,5092,5360
6615279,310,99,5,1980,99,1,1881,1980
1.00E+12,310,199,5,3980,199,1,3781,3980
1.00E+12,300,14560,20.8,70000,14560,1,55440,70000
8593950,310,180,5,3600,180,1,3420,3600
1.00E+12,310,199,5,3980,796,4,15124,15920
1.00E+12,310,310,8.9,3480,620,2,6340,6960
9751368,310,3574,9,39800,3574,1,36226,39800
1.00E+12,310,79,8.9,880,157,2,1603,1760
1.00E+12,200,2552,8.8,29000,2552,1,26448,29000
6618348,601,247,5,4950,247,1,4703,4950
8953588,340,338,5,6780,338,1,6442,6780
1.00E+12,340,198,5,3980,396,2,7564,7960
10472598,310,868,9.2,9480,868,1,8612,9480
1.00E+12,310,288,10,2880,576,2,5184,5760
1.00E+12,310,795,5,15900,795,1,15105,15900
6609371,310,249,5,4980,249,1,4731,4980
1.00E+12,310,1436,5,28980,1436,1,27544,28980
1.00E+12,310,1446,14.5,10000,1446,1,8554,10000
1.00E+12,310,1952,14.5,13500,1952,1,11548,13500
1.00E+12,200,1276,16.4,7800,1276,1,6524,7800
1.00E+12,310,1285,18.4,6980,1285,1,5695,6980
8082162,310,653,9.4,6980,653,1,6327,6980
1.00E+12,310,391,9.4,4180,391,1,3789,4180
1.00E+12,300,1145,1,114500,1145,1,113355,114500
1.00E+12,200,6482,16,40600,6482,1,34118,40600
1.00E+12,200,1140,5,22900,1140,1,21760,22900
6840121,310,2617,58.1,4500,5233,2,3767,9000
1.00E+12,100,102,11.6,880,1734,17,13226,14960
1.00E+12,310,91,9.2,990,272,3,2698,2970
1.00E+12,310,916,9.2,9980,916,1,9064,9980
1.00E+12,200,1295,5,25900,1295,1,24605,25900
1.00E+12,310,62,6.3,980,123,2,1837,1960
1.00E+12,310,369,6.3,5880,369,1,5511,5880
1.00E+12,310,327,11,2980,327,1,2653,2980
8583141,310,225,5.9,3840,225,1,3615,3840
1.00E+12,601,865,9.7,8880,865,1,8015,8880
1.00E+12,200,3500,10,35000,3500,1,31500,35000
1.00E+12,310,702,9.1,7700,2106,3,20994,23100
2.10E+12,310,224,5,4480,224,1,4256,4480
2.10E+12,310,99,5,1980,198,2,3762,3960
1.00E+12,100,274,5,5480,274,1,5206,5480
1.00E+12,300,999,6.9,14400,999,1,13401,14400
1.00E+12,310,230,10,2300,230,1,2070,2300
2.10E+12,310,428,10,4280,856,2,7704,8560
2.10E+12,310,698,10,6980,2792,4,25128,27920
2.10E+12,310,2798,28,9980,5596,2,14364,19960
2.10E+12,310,598,10,5980,1196,2,10764,11960
1.00E+12,200,9192,12,76600,9192,1,67408,76600
1.00E+12,310,867,9.8,8880,867,1,8013,8880
1.00E+12,300,1150,1,115000,1150,1,113850,115000
1.00E+12,310,99,5,1980,99,1,1881,1980
8782154,310,499,5,9980,499,1,9481,9980
1.00E+12,310,149,5,2980,149,1,2831,2980
8076920,310,345,5,6900,690,2,13110,13800
7891089,601,287,14.5,1980,574,2,3386,3960
1.00E+12,200,7200,20,36000,7200,1,28800,36000
10530001,205,3048,33.5,9100,3048,1,6052,9100
1.00E+12,310,1957,14.5,13500,5871,3,34629,40500
1.00E+12,300,1609,21.6,7450,1609,1,5841,7450
2.10E+12,501,294,6.9,4280,294,1,3986,4280
2.10E+12,501,10583,53.4,19800,10583,1,9217,19800
1.00E+12,500,27940,19.5,143400,27940,1,115460,143400
1.00E+12,310,171,1.7,9980,171,1,9809,9980
1.00E+12,310,171,1.7,9980,171,1,9809,9980
1.00E+12,200,5664,21.4,26500,5664,1,20836,26500
1.00E+12,200,1120,6.6,16900,1120,1,15780,16900
1.00E+12,310,7249,14.5,49980,7249,1,42731,49980
1.00E+12,310,315,7,4500,315,1,4185,4500
1.00E+12,340,103,7,1480,309,3,4131,4440
1.00E+12,310,1054,13.2,7980,1054,1,6926,7980
8333648,310,292,8.6,3380,292,1,3088,3380
1.00E+12,601,1054,13.2,7980,1054,1,6926,7980
1.00E+12,310,138,7,1980,138,1,1842,1980
1.00E+12,310,475,14.5,3280,475,1,2805,3280
1.00E+12,310,255,10,2550,255,1,2295,2550
2.10E+12,200,312,24,1300,624,2,1976,2600
1.00E+12,310,327,8,4100,327,1,3773,4100
8333610,310,335,8,4200,335,1,3865,4200
1.00E+12,310,7651,15.4,49800,7651,1,42149,49800
1.00E+12,205,10432,40.8,25600,10432,1,15168,25600
1.00E+12,601,838,9.7,8600,838,1,7762,8600
6609432,310,133,5,2660,266,2,5054,5320
1.00E+12,310,823,11.8,6980,823,1,6157,6980
2.10E+12,310,539,11.8,4580,539,1,4041,4580
1.00E+12,100,351,11.8,2980,351,1,2629,2980
1.00E+12,501,944,11.8,8000,1888,2,14112,16000
1.00E+12,300,9610,16.3,59000,9610,1,49390,59000
1.00E+12,200,25970,20.9,124000,25970,1,98030,124000
2.10E+12,310,2094,24,8725,4188,2,13262,17450
1.00E+12,205,800,28.8,2780,800,1,1980,2780
2.10E+12,205,876,20,4380,3504,4,14016,17520
1.00E+12,200,1295,5,25900,1295,1,24605,25900
1.00E+12,310,348,7,4980,1044,3,13896,14940
1.00E+12,100,6389,16.9,37700,6389,1,31311,37700
1.00E+12,200,5550,15,37000,5550,1,31450,37000
1.00E+12,310,659,8.8,7480,659,1,6821,7480
1.00E+12,310,923,8.8,10480,923,1,9557,10480
6616877,310,278,10,2780,834,3,7506,8340
1.00E+12,310,524,6.6,7980,524,1,7456,7980
2.10E+12,200,1907,12.9,14800,1907,1,12893,14800
2.10E+12,340,138,7,1980,138,1,1842,1980
7118515,310,560,10,5600,560,1,5040,5600
1.00E+12,310,790,10,7900,790,1,7110,7900
1.00E+12,310,790,10,7900,790,1,7110,7900
1.00E+12,310,2498,10,24980,2498,1,22482,24980
1.00E+12,240,3492,41.7,8380,6984,2,9776,16760
1.00E+12,205,3492,41.7,8380,6984,2,9776,16760
2.10E+12,310,1278,25.7,4980,1278,1,3702,4980
1.00E+12,100,599,5,11980,599,1,11381,11980
8351890,601,90,5,1800,180,2,3420,3600
2.10E+12,310,1021,7,14586,1021,1,13565,14586
1.00E+12,310,990,10,9900,990,1,8910,9900
2.10E+12,310,378,10,3780,378,1,3402,3780
2.10E+12,310,468,10,4680,468,1,4212,4680
1.00E+12,310,398,10,3980,23880,60,214920,238800
2.10E+12,100,244,15.1,1620,976,4,5504,6480
2.10E+12,501,244,15.1,1620,976,4,5504,6480
1.00E+12,200,12180,14.5,84000,12180,1,71820,84000
1.00E+12,310,1119,5,22380,1119,1,21261,22380
1.00E+12,300,1547,5,31200,1547,1,29653,31200
1.00E+12,310,139,11.6,1200,139,1,1061,1200
8116426,310,152,7,2180,304,2,4056,4360
10006532,310,201,7,2880,201,1,2679,2880
1.00E+12,310,229,7,3280,229,1,3051,3280
2.10E+12,310,3033,25.6,11850,6066,2,17634,23700
1.00E+12,310,47,6.9,680,94,2,1266,1360
1.00E+12,310,124,7,1780,248,2,3312,3560
1.00E+12,310,178,7,2550,356,2,4744,5100
9014363,310,236,7,3380,236,1,3144,3380
1.00E+12,200,17100,18,95000,17100,1,77900,95000
1.00E+12,200,11210,19,59000,11210,1,47790,59000
1.00E+12,310,1200,16,7500,2400,2,12600,15000
1.00E+12,240,1200,16,7500,2400,2,12600,15000
1.00E+12,310,983,8.2,11980,983,1,10997,11980
1.00E+12,300,1500,18.1,8280,1500,1,6780,8280
1.00E+12,310,110,7,1580,110,1,1470,1580
1.00E+12,200,8280,12,69000,8280,1,60720,69000
1.00E+12,200,8280,12,69000,8280,1,60720,69000
1.00E+12,310,229,7,3280,229,1,3051,3280
1.00E+12,200,224,4,5600,224,1,5376,5600
1.00E+12,200,2890,10,28900,11560,4,104040,115600
8225962,310,433,9,4800,433,1,4367,4800
1.00E+12,310,712,9,7900,712,1,7188,7900
7688157,310,498,10,4980,498,1,4482,4980
1.00E+12,200,1878,22.1,8500,1878,1,6622,8500
1.00E+12,200,1878,22.1,8500,3756,2,13244,17000
1.00E+12,310,499,5,9980,499,1,9481,9980
2.10E+12,200,2581,28.7,8980,2581,1,6399,8980
,,,,,,,,
1.00E+12,240,4002,36.7,10900,8003,2,13797,21800
1.00E+12,310,498,10,4980,498,1,4482,4980
1.00E+12,240,1402,25.6,5480,1402,1,4078,5480
1.00E+12,310,208,8.5,2450,208,1,2242,2450
2.10E+12,310,168,8.5,1980,168,1,1812,1980
8456661,310,144,8.5,1700,144,1,1556,1700
2.10E+12,200,431,35.9,1200,1294,3,2306,3600
1.00E+12,310,348,10,3480,348,1,3132,3480
1.00E+12,310,49,4.9,990,98,2,1882,1980
1.00E+12,310,59,5,1180,59,1,1121,1180
8121228,310,64,5,1280,640,10,12160,12800
1.00E+12,100,1522,14.5,10500,1522,1,8978,10500
2.10E+12,310,1644,24,6850,1644,1,5206,6850
8308821,310,413,14.4,2870,413,1,2457,2870
1.00E+12,310,761,14.4,5280,761,1,4519,5280
1.00E+12,310,336,9.7,3480,336,1,3144,3480
2.10E+12,100,162,9.6,1680,162,1,1518,1680
1.00E+12,100,1427,14.4,9900,1427,1,8473,9900
2.10E+12,200,4772,36.8,12980,9543,2,16417,25960
1.00E+12,200,12324,31.6,39000,12324,1,26676,39000
2.10E+12,310,289,16.1,1800,289,1,1511,1800
2.10E+12,310,214,13.2,1620,3424,16,22496,25920
2.10E+12,200,289,16.1,1800,578,2,3022,3600
2.10E+12,340,243,7,3480,243,1,3237,3480
1.00E+12,310,138,7,1980,414,3,5526,5940
2.10E+12,310,348,7,4980,348,1,4632,4980
1.00E+12,200,5000,7.7,64900,10000,2,119800,129800
1.00E+12,310,846,10,8460,6768,8,60912,67680
1.00E+12,310,796,7,11380,796,1,10584,11380
1.00E+12,310,131,7,1880,131,1,1749,1880
1.00E+12,310,499,5,9980,499,1,9481,9980
1.00E+12,310,649,5,12980,1298,2,24662,25960
2.10E+12,310,595,5,11900,595,1,11305,11900
2.10E+12,310,645,5,12900,1290,2,24510,25800
1.00E+12,310,198,10,1980,198,1,1782,1980
8238147,310,698,7,9980,698,1,9282,9980
1.00E+12,200,19232,20.9,91800,19232,1,72568,91800
1.00E+12,310,588,10,5880,1176,2,10584,11760
2.10E+12,310,1470,27.8,5280,1470,1,3810,5280
2.10E+12,200,1470,27.8,5280,1470,1,3810,5280
7938698,511,7240,50,14480,14480,2,14480,28960
1.00E+12,310,1238,6.9,17980,1238,1,16742,17980
1.00E+12,310,673,6.9,9780,673,1,9107,9780
8989814,310,322,6.9,4680,966,3,13074,14040
1.00E+12,200,6223,12.7,49000,6223,1,42777,49000
1.00E+12,200,970,14.9,6500,970,1,5530,6500
1.00E+12,310,2667,11.6,22900,5334,2,40466,45800
1.00E+12,200,626,9.8,6400,1878,3,17322,19200
6610015,310,124,5,2480,496,4,9424,9920
1.00E+12,310,418,10,4180,418,1,3762,4180
2.10E+12,310,148,10,1480,296,2,2664,2960
1.00E+12,310,3522,28,12580,3522,1,9058,12580
,,,,,,,,
1.00E+12,310,1974,39.9,4950,5921,3,8929,14850
7165280,310,98,9.8,1000,98,1,902,1000
1.00E+12,310,358,10,3580,1432,4,12888,14320
8055928,310,396,10,3960,7920,20,71280,79200
1.00E+12,310,146,3.9,3780,146,1,3634,3780
1.00E+12,310,347,3.9,8980,347,1,8633,8980
1.00E+12,310,215,3.9,5580,215,1,5365,5580
1.00E+12,310,348,10,3480,348,1,3132,3480
8228112,310,2335,52.7,4430,9341,4,8379,17720
2.10E+12,200,9922,52.5,18900,9922,1,8978,18900
1.00E+12,501,89,1,8980,178,2,17782,17960
7647882,310,885,10,8850,885,1,7965,8850
1.00E+12,310,200,10,2000,2000,10,18000,20000
1.00E+12,200,6959,12.7,54800,6959,1,47841,54800
8233374,310,378,10.9,3480,378,1,3102,3480
1.00E+12,310,978,10.9,8980,978,1,8002,8980
7891089,100,303,15.3,1980,303,1,1677,1980
2.10E+12,100,476,10.9,4380,476,1,3904,4380
1.00E+12,205,3600,30,12000,3600,1,8400,12000
1.00E+12,200,22200,15,148000,22200,1,125800,148000
1.00E+12,200,410,2.9,13900,410,1,13490,13900
1.00E+12,200,13900,20,69500,13900,1,55600,69500
1.00E+12,310,3478,53.5,6500,6955,2,6045,13000
1.00E+12,310,6960,14.5,48000,6960,1,41040,48000
1.00E+12,340,313,7,4480,313,1,4167,4480
1.00E+12,340,82,6.9,1180,82,1,1098,1180
6609429,340,96,7,1380,96,1,1284,1380
10618315,310,1853,9.3,19980,1853,1,18127,19980
1.00E+12,310,288,8.2,3500,288,1,3212,3500
1.00E+12,310,164,8.2,2000,164,1,1836,2000
1.00E+12,310,658,7,9400,658,1,8742,9400
7938688,310,398,10,3980,398,1,3582,3980
1.00E+12,310,798,10,7980,2394,3,21546,23940
1.00E+12,340,3088,28.3,10900,6176,2,15624,21800
2.10E+12,340,348,7,4980,348,1,4632,4980
1.00E+12,310,30994,26.2,118300,30994,1,87306,118300
2.10E+12,310,350,10,3500,1050,3,9450,10500
1.00E+12,340,235,7,3360,470,2,6250,6720
1.00E+12,310,398,10,3980,398,1,3582,3980
1.00E+12,310,371,7,5280,371,1,4909,5280
1.00E+12,310,526,7,7480,526,1,6954,7480
8029615,310,752,18.8,4000,752,1,3248,4000
1.00E+12,310,783,14.3,5480,783,1,4697,5480
1.00E+12,310,1124,18.8,5980,1124,1,4856,5980
6864891,310,497,14.3,3480,497,1,2983,3480
1.00E+12,310,157,14.3,1100,157,1,943,1100
1.00E+12,100,1124,18.8,5980,1124,1,4856,5980
8333610,100,789,18.8,4200,789,1,3411,4200
1.00E+12,100,949,14.3,6650,949,1,5701,6650
1.00E+12,310,174,5,3480,174,1,3306,3480
2.10E+12,310,1155,46.6,2480,4620,4,5300,9920
2.10E+12,310,1887,34.4,5480,15096,8,28744,43840
7074037,310,291,6.4,4580,1164,4,17156,18320
1.00E+12,200,18360,17,108000,18360,1,89640,108000
1.00E+12,200,2450,14.5,16900,2450,1,14450,16900
1.00E+12,310,6230,7,89000,6230,1,82770,89000
2.10E+12,200,1913,25.6,7475,3826,2,11124,14950
1.00E+12,310,172,8.6,2000,172,1,1828,2000
8210513,310,1818,8.7,20900,1818,1,19082,20900
6618824,310,179,8.6,2080,179,1,1901,2080
1.00E+12,310,189,9.5,1980,189,1,1791,1980
1.00E+12,310,3045,14.5,21000,12180,4,71820,84000
1.00E+12,100,4812,19.2,25000,4812,1,20188,25000
1.00E+12,100,3850,19.3,20000,7700,2,32300,40000
1.00E+12,310,64,5,1280,256,4,4864,5120
1.00E+12,310,733,7,10480,733,1,9747,10480
1.00E+12,200,1596,11.6,13700,1596,1,12104,13700
2.10E+12,310,342,9.8,3500,684,2,6316,7000
6609573,310,74,5,1480,222,3,4218,4440
6613175,310,243,7,3480,243,1,3237,3480
6609402,310,628,7,8980,1256,2,16704,17960
1.00E+12,310,303,8.7,3480,303,1,3177,3480
1.00E+12,200,9520,20.9,45500,9520,1,35980,45500
1.00E+12,310,798,10,7980,798,1,7182,7980
6609747,310,173,7,2480,173,1,2307,2480
1.00E+12,310,90,5,1800,90,1,1710,1800
1.00E+12,310,359,14.5,2480,359,1,2121,2480
1.00E+12,310,432,14.5,2980,432,1,2548,2980
10006532,100,417,14.5,2880,417,1,2463,2880
1.00E+12,310,417,14.5,2880,834,2,4926,5760
1.00E+12,310,338,19,1780,338,1,1442,1780
1.00E+12,310,338,19,1780,338,1,1442,1780
1.00E+12,310,566,19,2980,566,1,2414,2980
1.00E+12,310,1295,7,18500,3885,3,51615,55500
1.00E+12,200,11250,5,225000,11250,1,213750,225000
1.00E+12,240,6160,44,14000,6160,1,7840,14000
1.00E+12,240,2200,44,5000,4400,2,5600,10000
2.10E+12,310,134,5,2680,134,1,2546,2680
1.00E+12,310,399,5,7980,399,1,7581,7980
1.00E+12,200,8838,25.2,35100,8838,1,26262,35100
1.00E+12,310,1679,8.9,18880,1679,1,17201,18880
8333620,310,305,8.4,3650,305,1,3345,3650
1.00E+12,511,255,25,1020,1530,6,4590,6120
2.10E+12,310,363,8.9,4080,726,2,7434,8160
2.10E+12,310,354,8.9,3980,708,2,7252,7960
1.00E+12,310,1265,55,2300,25300,20,20700,46000
8086074,310,452,19,2380,452,1,1928,2380
1.00E+12,310,2130,59.5,3580,4260,2,2900,7160
8912904,310,182,5,3650,364,2,6936,7300
8333630,310,89,5,1780,356,4,6764,7120
1.00E+12,340,194,7,2780,388,2,5172,5560
1.00E+12,310,284,8.9,3180,3410,12,34750,38160
1.00E+12,100,28,1,2800,28,1,2772,2800
1.00E+12,100,98,1,9800,196,2,19404,19600
7707168,501,59,1,5980,59,1,5921,5980
8315733,501,24,1,2480,24,1,2456,2480
2.10E+12,310,2657,26.6,9980,2657,1,7323,9980
1.00E+12,310,327,8.2,3980,327,1,3653,3980
1.00E+12,310,594,8.5,6980,594,1,6386,6980
6615474,310,218,8.5,2560,436,2,4684,5120
2.10E+12,205,15000,50,30000,15000,1,15000,30000
7343938,501,176,5.9,2980,176,1,2804,2980
2.10E+12,310,548,14.4,3800,548,1,3252,3800
1.00E+12,310,663,14.4,4600,663,1,3937,4600
1.00E+12,310,1007,14.4,6980,2014,2,11946,13960
1.00E+12,100,658,18.9,3480,658,1,2822,3480
2.10E+12,100,3407,31.5,10800,6813,2,14787,21600
6616801,100,429,14.4,2980,429,1,2551,2980
1.00E+12,310,575,5,11500,575,1,10925,11500
1.00E+12,310,324,5,6480,648,2,12312,12960
1.00E+12,310,699,5,13980,699,1,13281,13980
1.00E+12,310,450,5,9000,1800,4,34200,36000
1.00E+12,200,28470,22.1,128880,28470,1,100410,128880
1.00E+12,500,28470,22.1,128880,28470,1,100410,128880
1.00E+12,310,1058,13.3,7980,1058,1,6922,7980
1.00E+12,310,65,3.6,1780,129,2,3431,3560
1.00E+12,310,254,3.6,7000,508,2,13492,14000
10627392,310,156,3.6,4320,156,1,4164,4320
1.00E+12,310,926,13.3,6980,926,1,6054,6980
1.00E+12,310,425,7.2,5900,425,1,5475,5900
8083461,310,164,7.2,2280,164,1,2116,2280
1.00E+12,310,1330,53.6,2480,2659,2,2301,4960
1.00E+12,310,49,5,980,98,2,1862,1960
1.00E+12,310,1273,33.5,3800,2546,2,5054,7600
1.00E+12,310,1029,6.5,15800,1029,1,14771,15800
1.00E+12,200,8100,18,45000,8100,1,36900,45000
1.00E+12,310,1184,24.3,4880,1184,1,3696,4880
1.00E+12,200,3900,10,39000,3900,1,35100,39000
1.00E+12,340,180,7,2580,360,2,4800,5160
7242787,340,271,7,3880,271,1,3609,3880
1.00E+12,500,10350,17.5,59000,10350,1,48650,59000
1.00E+12,500,7600,19,40000,7600,1,32400,40000
1.00E+12,200,13340,23,58000,13340,1,44660,58000
1.00E+12,310,578,10,5780,2312,4,20808,23120
7113618,310,288,10,2880,864,3,7776,8640
1.00E+12,200,5200,20,26000,5200,1,20800,26000
2.10E+12,200,1000,16.7,5980,3000,3,14940,17940
2.10E+12,200,1000,20.1,4980,3000,3,11940,14940
2.10E+12,310,693,7,9900,693,1,9207,9900
2.10E+12,310,4693,33.8,13900,4693,1,9207,13900
1.00E+12,310,487,7.4,6580,973,2,12187,13160
9669780,310,435,7.4,5880,1305,3,16335,17640
1.00E+12,340,2278,16.3,13980,2278,1,11702,13980
1.00E+12,340,114,11.5,990,114,1,876,990
9701616,340,1300,16.3,7980,1300,1,6680,7980
1.00E+12,340,1304,16.3,8000,1304,1,6696,8000
1.00E+12,310,398,10,3980,398,1,3582,3980
8634221,310,389,5,7780,389,1,7391,7780
1.00E+12,310,484,5,9680,484,1,9196,9680
2.10E+12,310,80,10,800,480,6,4320,4800
2.10E+12,310,198,10,1980,594,3,5346,5940
1.00E+12,310,455,9.7,4680,910,2,8450,9360
2.10E+12,310,1124,16.3,6900,2248,2,11552,13800
1.00E+12,340,314,7,4490,314,1,4176,4490
8598301,310,82,6.9,1180,246,3,3294,3540
1.00E+12,310,598,10,5980,1196,2,10764,11960
1.00E+12,310,680,10,6800,1360,2,12240,13600
6820552,310,117,7,1680,234,2,3126,3360
1.00E+12,205,1194,30,3980,3582,3,8358,11940
1.00E+12,310,1198,10,11980,1198,1,10782,11980
1.00E+12,310,199,5,3980,199,1,3781,3980
2.10E+12,310,1639,16.9,9680,1639,1,8041,9680
2.10E+12,310,7071,35.4,19980,7071,1,12909,19980
1.00E+12,310,152,7,2180,304,2,4056,4360
9527127,310,537,6.7,7980,537,1,7443,7980
1.00E+12,310,348,7,4980,348,1,4632,4980
1.00E+12,310,1998,10,19980,1998,1,17982,19980
1.00E+12,200,3900,10,39000,3900,1,35100,39000
1.00E+12,200,35440,8,443000,35440,1,407560,443000
1.00E+12,240,2646,36.8,7200,7939,3,13661,21600
1.00E+12,310,1433,36.7,3900,1433,1,2467,3900
10041281,310,193,4.8,3980,193,1,3787,3980
1.00E+12,310,872,4.8,17980,872,1,17108,17980
1.00E+12,310,484,4.8,9980,484,1,9496,9980
1.00E+12,310,193,4.8,3980,193,1,3787,3980
2.10E+12,310,168,5.5,3080,168,1,2912,3080
1.00E+12,310,2268,14.6,15500,4535,2,26465,31000
1.00E+12,310,570,10,5700,570,1,5130,5700
1.00E+12,310,175,6.1,2880,175,1,2705,2880
1.00E+12,310,230,6.1,3780,230,1,3550,3780
1.00E+12,310,363,6.1,5980,363,1,5617,5980
1.00E+12,200,7875,15,52500,7875,1,44625,52500
1.00E+12,310,182,9.2,1980,546,3,5394,5940
8562071,310,596,9.2,6480,596,1,5884,6480
1.00E+12,310,552,9.2,6000,552,1,5448,6000
1.00E+12,501,56,1,5660,56,1,5604,5660
1.00E+12,310,288,10,2880,288,1,2592,2880
1.00E+12,310,424,5,8480,848,2,16112,16960
10008275,310,69,5,1380,345,5,6555,6900
1.00E+12,310,374,14.5,2580,374,1,2206,2580
1.00E+12,310,119,5,2380,119,1,2261,2380
1.00E+12,200,5900,10,59000,5900,1,53100,59000
1.00E+12,200,9460,26.3,36000,9460,1,26540,36000
1.00E+12,310,2595,14.5,17900,2595,1,15305,17900
1.00E+12,200,9675,15,64500,9675,1,54825,64500
2.10E+12,310,308,7,4400,308,1,4092,4400
2.10E+12,310,262,5,5250,262,1,4988,5250
2.10E+12,310,198,10,1980,396,2,3564,3960
1.00E+12,310,498,10,4980,498,1,4482,4980
1.00E+12,310,478,12.6,3800,3346,7,23254,26600
1.00E+12,310,406,14.5,2800,406,1,2394,2800
1.00E+12,310,478,12.6,3800,478,1,3322,3800
1.00E+12,200,406,14.5,2800,406,1,2394,2800
1.00E+12,200,406,14.5,2800,406,1,2394,2800
1.00E+12,200,609,14.5,4200,609,1,3591,4200
1.00E+12,200,378,12.6,3000,378,1,2622,3000
1.00E+12,200,3586,16.3,22000,3586,1,18414,22000
2.10E+12,310,104,5,2080,208,2,3952,4160
6609544,310,129,5,2580,645,5,12255,12900
1.00E+12,300,3384,12.6,26900,3384,1,23516,26900
1.00E+12,310,778,10,7780,1556,2,14004,15560
1.00E+12,310,628,10,6280,628,1,5652,6280
1.00E+12,310,998,10,9980,998,1,8982,9980
1.00E+12,310,698,10,6980,698,1,6282,6980
6609591,310,533,11.6,4580,533,1,4047,4580
1.00E+12,310,693,7,9900,693,1,9207,9900
2.10E+12,310,290,10,2900,290,1,2610,2900
1.00E+12,310,134,4.8,2780,134,1,2646,2780
1.00E+12,310,139,4.8,2880,139,1,2741,2880
1.00E+12,310,7411,28,26500,7411,1,19089,26500
6615244,310,160,8.9,1800,800,5,8200,9000
1.00E+12,310,901,8.9,10100,901,1,9199,10100
6615248,310,205,8.9,2300,205,1,2095,2300
1.00E+12,100,187,14.4,1300,187,1,1113,1300
7335759,310,264,7,3780,792,3,10548,11340
2.10E+12,340,2534,25.6,9900,2534,1,7366,9900
1.00E+12,310,98,10,980,98,1,882,980
1.00E+12,200,12000,10,120000,12000,1,108000,120000
1.00E+12,310,278,10,2780,834,3,7506,8340
7049673,501,9,1,900,36,4,3564,3600
7445176,501,9,0.9,990,9,1,981,990
1.00E+12,310,522,9.5,5480,522,1,4958,5480
7580466,310,1526,7,21800,1526,1,20274,21800
1.00E+12,500,11890,24.9,47800,11890,1,35910,47800
1.00E+12,200,7070,16.3,43470,7070,1,36400,43470
1.00E+12,200,1610,14.4,11200,1610,1,9590,11200
7167900,310,68,6.9,980,204,3,2736,2940
1.00E+12,310,453,7,6480,906,2,12054,12960
1.00E+12,310,99,5,1980,297,3,5643,5940
1.00E+12,310,19015,23.7,80100,19015,1,61085,80100
1.00E+12,310,413,7,5900,413,1,5487,5900
8103611,310,166,7,2380,166,1,2214,2380
1.00E+12,500,30411,10.9,279000,30411,1,248589,279000
1.00E+12,310,224,5,4480,448,2,8512,8960
1.00E+12,200,1892,12.7,14900,3784,2,26016,29800
9584035,601,375,5,7500,375,1,7125,7500
9599107,340,439,7,6280,439,1,5841,6280
1.00E+12,340,278,7,3980,278,1,3702,3980
1.00E+12,340,133,7,1910,133,1,1777,1910
6615660,340,152,7,2180,304,2,4056,4360
1.00E+12,310,959,9.6,9980,959,1,9021,9980
1.00E+12,100,62,9.5,650,3410,55,32340,35750
1.00E+12,200,170,10,1700,1700,10,15300,17000
1.00E+12,200,256,10,2560,6400,25,57600,64000
1.00E+12,205,2756,30.7,8980,2756,1,6224,8980
1.00E+12,310,778,7.1,10980,778,1,10202,10980
1.00E+12,200,3107,13,23900,3107,1,20793,23900
2.10E+12,310,301,7,4300,301,1,3999,4300
2.10E+12,310,2093,7,29900,6279,3,83421,89700
1.00E+12,240,7331,57.5,12750,14662,2,10838,25500
1.00E+12,310,6300,10,63000,6300,1,56700,63000
1.00E+12,511,1512,52.5,2880,42336,28,38304,80640
1.00E+12,310,324,5,6480,324,1,6156,6480
1.00E+12,300,474,1,47400,474,1,46926,47400
1.00E+12,205,2204,24.8,8900,2204,1,6696,8900
2.10E+12,200,1613,16.3,9900,3226,2,16574,19800
2.10E+12,310,149,5,2980,149,1,2831,2980
1.00E+12,200,4900,10,49000,4900,1,44100,49000
2.10E+12,310,524,11.7,4480,524,1,3956,4480
1.00E+12,310,349,11.7,2980,697,2,5263,5960
2.10E+12,100,395,11.7,3380,395,1,2985,3380
1.00E+12,100,1747,11.7,14900,1747,1,13153,14900
1.00E+12,100,2691,11.8,22900,2691,1,20209,22900
2.10E+12,100,1484,29.8,4980,1484,1,3496,4980
2.10E+12,200,1484,29.8,4980,1484,1,3496,4980
1.00E+12,200,2200,22,10000,2200,1,7800,10000
1.00E+12,310,124,5,2480,124,1,2356,2480
1.00E+12,310,224,5,4480,672,3,12768,13440
1.00E+12,310,1270,5,25400,1270,1,24130,25400
1.00E+12,310,472,7,6750,1416,3,18834,20250
1.00E+12,200,10910,14.3,76500,10910,1,65590,76500
1.00E+12,200,5430,15.5,35000,5430,1,29570,35000
1.00E+12,200,23950,5,479000,23950,1,455050,479000
1.00E+12,200,579,3,19300,579,1,18721,19300
2.10E+12,200,1422,15,9480,5688,4,32232,37920
1.00E+12,310,595,5,11900,595,1,11305,11900
1.00E+12,200,2200,10,22000,4400,2,39600,44000
1.00E+12,310,445,5.6,7980,445,1,7535,7980
10008970,310,183,5.6,3280,183,1,3097,3280
1.00E+12,310,445,5.6,7980,445,1,7535,7980
1.00E+12,310,473,5.6,8480,473,1,8007,8480
1.00E+12,310,623,7,8900,623,1,8277,8900
8108245,310,210,7,3000,210,1,2790,3000
1.00E+12,100,741,19,3900,741,1,3159,3900
1.00E+12,310,126,7,1800,252,2,3348,3600
1.00E+12,310,5655,14.5,39000,5655,1,33345,39000
1.00E+12,601,126,9.7,1300,126,1,1174,1300
1.00E+12,601,117,9.8,1200,117,1,1083,1200
2.10E+12,310,1740,11,15800,1740,1,14060,15800
8844842,310,232,5,4650,232,1,4418,4650
1.00E+12,200,2159,14.5,14890,2159,1,12731,14890
1.00E+12,310,698,7,9980,698,1,9282,9980
7020770,310,122,7,1750,732,6,9768,10500
1.00E+12,310,49,5,980,98,2,1862,1960
2.10E+12,310,378,9.5,3980,756,2,7204,7960
2.10E+12,240,2442,37,6600,7326,3,12474,19800
1.00E+12,310,800,10,8000,800,1,7200,8000
1.00E+12,310,19975,23.5,85000,19975,1,65025,85000
1.00E+12,310,350,10,3500,350,1,3150,3500
1.00E+12,200,235,23.5,1000,470,2,1530,2000
1.00E+12,200,1430,1.4,99000,1430,1,97570,99000
1.00E+12,310,2276,19,11980,2276,1,9704,11980
1.00E+12,310,533,14.5,3680,2132,4,12588,14720
1.00E+12,100,432,14.5,2980,432,1,2548,2980
7666356,100,1084,14.5,7480,1084,1,6396,7480
1.00E+12,310,75,5,1500,150,2,2850,3000
1.00E+12,310,840,5,16800,840,1,15960,16800
1.00E+12,310,1302,52.5,2480,13020,10,11780,24800
2.10E+12,310,123,5,2475,246,2,4704,4950
1.00E+12,205,1292,18.5,6980,1292,1,5688,6980
1.00E+12,310,1444,9,16000,2888,2,29112,32000
1.00E+12,310,3170,19.9,15900,3170,1,12730,15900
7134845,100,388,10,3880,388,1,3492,3880
1.00E+12,300,128,4,3200,128,1,3072,3200
1.00E+12,310,3980,20.9,19000,3980,1,15020,19000
1.00E+12,310,4780,20,23900,4780,1,19120,23900
2.10E+12,310,488,7,6980,2440,5,32460,34900
1.00E+12,310,329,9.5,3480,329,1,3151,3480
8275727,310,944,9.5,9980,944,1,9036,9980
1.00E+12,310,398,10,3980,398,1,3582,3980
1.00E+12,310,418,10,4180,836,2,7524,8360
2.10E+12,601,137,11.6,1180,137,1,1043,1180
1.00E+12,100,3600,46.2,7800,3600,1,4200,7800
2.10E+12,100,1066,43,2480,1066,1,1414,2480
2.10E+12,310,1710,34.9,4900,5130,3,9570,14700
2.10E+12,310,301,7,4300,1204,4,15996,17200
1.00E+12,601,347,11.6,2980,347,1,2633,2980
1.00E+12,340,69,7,990,621,9,8289,8910
1.00E+12,310,598,10,5980,598,1,5382,5980
6609534,310,124,5,2480,124,1,2356,2480
1.00E+12,240,1402,41.5,3380,2804,2,3956,6760
1.00E+12,500,3900,10,39000,3900,1,35100,39000
1.00E+12,310,592,9.9,5980,2961,5,26939,29900
2.10E+12,340,170,6.3,2680,170,1,2510,2680
7588534,340,63,6.3,1000,63,1,937,1000
2.10E+12,340,10049,53.2,18900,10049,1,8851,18900
2.10E+12,340,258,6.3,4080,258,1,3822,4080
1.00E+12,310,4114,55,7480,8228,2,6732,14960
1.00E+12,340,333,6.8,4880,333,1,4547,4880
2.10E+12,200,3318,28,11850,23226,7,59724,82950
1.00E+12,240,1153,11.6,9900,1153,1,8747,9900
8350710,100,389,16.3,2390,389,1,2001,2390
1.00E+12,200,67297,20.8,322800,67297,1,255503,322800
1.00E+12,500,67297,20.8,322800,67297,1,255503,322800
1.00E+12,310,1300,10,13000,1300,1,11700,13000
2.10E+12,310,49,5,980,98,2,1862,1960
1.00E+12,310,349,5,6980,698,2,13262,13960
1.00E+12,310,199,5,3980,199,1,3781,3980
1.00E+12,340,43185,17.1,252000,43185,1,208815,252000
1.00E+12,310,890,10,8900,890,1,8010,8900
1.00E+12,310,1490,10,14900,1490,1,13410,14900
1.00E+12,310,4205,14.5,29000,4205,1,24795,29000
1.00E+12,310,448,10,4480,896,2,8064,8960
2.10E+12,310,509,7,7280,509,1,6771,7280
1.00E+12,200,22680,12,189000,22680,1,166320,189000
1.00E+12,205,1110,23.1,4800,2220,2,7380,9600
1.00E+12,310,580,10,5800,580,1,5220,5800
1.00E+12,200,8010,23,34900,8010,1,26890,34900
1.00E+12,500,17920,24.9,72000,17920,1,54080,72000
8986773,310,62,3.5,1780,62,1,1718,1780
1.00E+12,310,657,9.5,6950,1971,3,18879,20850
1.00E+12,310,848,9.4,8980,2544,3,24396,26940
7513645,310,338,9.4,3580,1014,3,9726,10740
6615115,310,444,9.4,4700,1332,3,12768,14100
2.10E+12,310,986,27.5,3580,2958,3,7782,10740
1.00E+12,310,754,9.4,7980,2262,3,21678,23940
1.00E+12,310,449,5,8980,1347,3,25593,26940
1.00E+12,200,4867,7.9,62000,4867,1,57133,62000
8333668,100,75,10,750,150,2,1350,1500
7587257,100,65,10,650,130,2,1170,1300
1.00E+12,100,499,5,9980,499,1,9481,9980
1.00E+12,310,199,5,3980,398,2,7562,7960
1.00E+12,310,2434,11.6,20900,2434,1,18466,20900
8627427,200,4390,10,43900,4390,1,39510,43900
7709932,310,114,5,2280,114,1,2166,2280
7335675,310,973,7,13900,973,1,12927,13900
1.00E+12,310,805,7,11500,805,1,10695,11500
2.10E+12,310,323,11.6,2780,323,1,2457,2780
2.10E+12,240,1645,33,4980,1645,1,3335,4980
6616350,340,488,7,6980,488,1,6492,6980
1.00E+12,310,346,7,4950,692,2,9208,9900
1.00E+12,310,348,7,4980,348,1,4632,4980
1.00E+12,310,91,7,1300,182,2,2418,2600
1.00E+12,310,1118,7,15980,1118,1,14862,15980
1.00E+12,310,129,5,2580,645,5,12255,12900
1.00E+12,601,149,5,2980,149,1,2831,2980
1.00E+12,200,25000,20,125000,25000,1,100000,125000
1.00E+12,310,298,10,2980,298,1,2682,2980
1.00E+12,310,404,7,5780,404,1,5376,5780
1.00E+12,310,190,5,3800,190,1,3610,3800
1.00E+12,310,129,5,2580,387,3,7353,7740
1.00E+12,310,625,5,12500,625,1,11875,12500
1.00E+12,310,44,5,880,88,2,1672,1760
1.00E+12,310,295,5,5900,295,1,5605,5900
1.00E+12,500,6940,17.4,40000,131860,19,628140,760000
1.00E+12,200,980,10,9800,980,1,8820,9800
1.00E+12,310,383,7,5480,1149,3,15291,16440
1.00E+12,310,733,7,10480,1466,2,19494,20960
1.00E+12,200,200,4,5000,400,2,9600,10000
1.00E+12,200,11980,15,79900,11980,1,67920,79900
1.00E+12,200,7200,8,90000,7200,1,82800,90000
1.00E+12,310,387,6.6,5880,1161,3,16479,17640
1.00E+12,310,222,6.6,3380,666,3,9474,10140
1.00E+12,511,3575,55,6500,14300,4,11700,26000
1.00E+12,310,598,10,5980,1794,3,16146,17940
1.00E+12,340,69,7,990,69,1,921,990
1.00E+12,340,488,7,6980,488,1,6492,6980
1.00E+12,340,1398,7,19980,1398,1,18582,19980
1.00E+12,340,390,7,5580,390,1,5190,5580
1.00E+12,340,698,7,9980,698,1,9282,9980
1.00E+12,340,439,7,6280,439,1,5841,6280
1.00E+12,340,1048,7,14980,2096,2,27864,29960
1.00E+12,511,755,39.7,1900,2264,3,3436,5700
1.00E+12,310,2781,9.6,28900,2781,1,26119,28900
1.00E+12,310,3610,19,19000,3610,1,15390,19000
1.00E+12,310,2595,14.5,17900,2595,1,15305,17900
1.00E+12,310,795,5,15900,795,1,15105,15900
1.00E+12,500,575,5,11500,1150,2,21850,23000
1.00E+12,240,834,10.8,7700,10002,12,82398,92400
1.00E+12,240,520,17.4,2980,520,1,2460,2980
1.00E+12,240,415,17.4,2380,830,2,3930,4760
8097965,310,536,8.3,6480,536,1,5944,6480
1.00E+12,310,1809,16.8,10780,1809,1,8971,10780
2.10E+12,310,2068,14.9,13900,2068,1,11832,13900
1.00E+12,310,690,10,6900,690,1,6210,6900
1.00E+12,310,798,10,7980,798,1,7182,7980
8337867,310,250,10,2500,250,1,2250,2500
1.00E+12,240,1440,33.5,4300,7200,5,14300,21500
1.00E+12,340,506,25.6,1980,1012,2,2948,3960
1.00E+12,200,17688,24.7,71550,17688,1,53862,71550
1.00E+12,310,11410,23.3,49000,11410,1,37590,49000
1.00E+12,500,11410,23.3,49000,11410,1,37590,49000
2.10E+12,240,2003,28.7,6980,4006,2,9954,13960
1.00E+12,200,17550,9.8,180000,17550,1,162450,180000
1.00E+12,310,265,10,2650,265,1,2385,2650
1.00E+12,310,1797,36.7,4900,5390,3,9310,14700
1.00E+12,310,424,5,8480,1272,3,24168,25440
1.00E+12,310,395,5,7900,395,1,7505,7900
6615745,310,474,9.5,4980,474,1,4506,4980
1.00E+12,310,569,9.5,5980,569,1,5411,5980
1.00E+12,100,6365,14.5,43900,6365,1,37535,43900
1.00E+12,200,7632,24.5,31200,7632,1,23568,31200
1.00E+12,310,267,8.9,3000,533,2,5467,6000
1.00E+12,310,158,8.9,1780,633,4,6487,7120
1.00E+12,310,199,5,3980,2388,12,45372,47760
1.00E+12,300,49,1,4980,980,20,98620,99600
1.00E+12,310,595,7,8500,2380,4,31620,34000
1.00E+12,310,149,5,2980,149,1,2831,2980
1.00E+12,200,9345,15,62300,9345,1,52955,62300
1.00E+12,100,395,5,7900,395,1,7505,7900
1.00E+12,300,1500,16.7,8980,3000,2,14960,17960
1.00E+12,100,84,5,1680,84,1,1596,1680
1.00E+12,100,830,10,8300,830,1,7470,8300
1.00E+12,310,149,5,2980,149,1,2831,2980
9063930,310,324,5,6480,648,2,12312,12960
1.00E+12,205,350,10,3500,350,1,3150,3500
1.00E+12,310,437,10,4380,437,1,3943,4380
8956834,310,297,10,2980,297,1,2683,2980
1.00E+12,310,197,9.9,1980,197,1,1783,1980
1.00E+12,310,79,5,1580,237,3,4503,4740
8225962,310,240,5,4800,720,3,13680,14400
1.00E+12,310,1198,10,11980,1198,1,10782,11980
2.10E+12,310,4998,10,49980,4998,1,44982,49980
1.00E+12,310,900,10,9000,900,1,8100,9000
1.00E+12,200,1440,12,12000,2880,2,21120,24000
1.00E+12,300,8900,10,89000,8900,1,80100,89000
1.00E+12,310,498,10,4980,996,2,8964,9960
1.00E+12,310,34,5,680,102,3,1938,2040
8609842,511,396,36.7,1080,3564,9,6156,9720
2.10E+12,200,6693,33.5,19980,13386,2,26574,39960
6609765,310,798,10,7980,798,1,7182,7980
8570314,310,628,10,6280,1884,3,16956,18840
1.00E+12,100,56,7,800,112,2,1488,1600
1.00E+12,200,12720,24,53000,12720,1,40280,53000
1.00E+12,500,12720,24,53000,12720,1,40280,53000
2.10E+12,310,2372,41.4,5730,2372,1,3358,5730
2.10E+12,240,2372,41.4,5730,2372,1,3358,5730
2.10E+12,310,1489,6.8,21980,1489,1,20491,21980
1.00E+12,310,435,6.7,6480,435,1,6045,6480
1.00E+12,310,388,6.7,5780,388,1,5392,5780
1.00E+12,310,66,6.7,990,66,1,924,990
8069282,310,168,6.7,2500,168,1,2332,2500
1.00E+12,200,3420,15,22800,3420,1,19380,22800
1.00E+12,100,103,2,5180,103,1,5077,5180
1.00E+12,310,1153,11.6,9900,1153,1,8747,9900
1.00E+12,300,8023,20.9,38300,8023,1,30277,38300
1.00E+12,310,8507,53.5,15900,17013,2,14787,31800
7891089,310,138,7,1980,414,3,5526,5940
7624187,310,90,10,900,630,7,5670,6300
1.00E+12,300,6490,20.9,31000,6490,1,24510,31000
1.00E+12,100,99,2,4980,99,1,4881,4980
8410642,100,39,2,1980,39,1,1941,1980
2.10E+12,100,145,5,2900,145,1,2755,2900
1.00E+12,310,12478,23.5,53100,12478,1,40622,53100
1.00E+12,200,912,19,4800,1824,2,7776,9600
1.00E+12,310,89,4.9,1810,177,2,3443,3620
1.00E+12,310,82,4.9,1680,82,1,1598,1680
1.00E+12,601,316,9.6,3280,316,1,2964,3280
8410603,340,180,7,2580,180,1,2400,2580
9596149,310,1390,10,13900,1390,1,12510,13900
1.00E+12,310,319,8,3980,319,1,3661,3980
1.00E+12,310,520,8,6480,520,1,5960,6480
1.00E+12,310,753,8,9380,753,1,8627,9380
1.00E+12,310,480,8,5980,960,2,11000,11960
1.00E+12,310,838,7,11980,838,1,11142,11980
1.00E+12,500,39247,35.8,109650,39247,1,70403,109650
1.00E+12,310,65,5,1300,65,1,1235,1300
10039403,100,592,7.9,7480,592,1,6888,7480
1.00E+12,501,275,7.9,3480,275,1,3205,3480
1.00E+12,310,32200,32.5,99000,64400,2,133600,198000
1.00E+12,310,385,7,5500,1540,4,20460,22000
1.00E+12,310,320,7,4580,960,3,12780,13740
7186745,310,838,7,11980,1676,2,22284,23960
2.10E+12,310,453,7,6480,906,2,12054,12960
1.00E+12,200,800,5,16000,800,1,15200,16000
1.00E+12,310,84,5,1680,84,1,1596,1680
1.00E+12,310,998,10,10000,2993,3,27007,30000
2.10E+12,310,876,10,8800,876,1,7924,8800
1.00E+12,200,1590,10,15900,1590,1,14310,15900
1.00E+12,240,973,9,10780,973,1,9807,10780
1.00E+12,310,838,7,11980,838,1,11142,11980
1.00E+12,300,3200,5,64000,3200,1,60800,64000
1.00E+12,310,144,5,2880,144,1,2736,2880
1.00E+12,340,208,7,2980,416,2,5544,5960
1.00E+12,200,6430,15,42900,12860,2,72940,85800
1.00E+12,310,6523,13.1,49800,6523,1,43277,49800
8044452,310,299,7,4280,299,1,3981,4280
8093106,310,3237,53.5,6050,6473,2,5627,12100
8093106,511,3237,53.5,6050,6473,2,5627,12100
7248547,310,546,13.7,3980,546,1,3434,3980
8677,310,8990,14.5,62000,8990,1,53010,62000
1.00E+12,310,13284,16.4,81000,13284,1,67716,81000
1.00E+12,200,13284,16.4,81000,13284,1,67716,81000
1.00E+12,310,199,5,3980,199,1,3781,3980
1.00E+12,310,299,5,5980,897,3,17043,17940
2.10E+12,200,2000,3.2,62800,2000,1,60800,62800
1.00E+12,240,1121,16.3,6880,2242,2,11518,13760
1.00E+12,310,7824,16.3,48000,7824,1,40176,48000
1.00E+12,310,328,10,3280,328,1,2952,3280
1.00E+12,310,119,5,2380,119,1,2261,2380
1.00E+12,200,4932,9,54800,14796,3,149604,164400
1.00E+12,601,485,9.7,4980,485,1,4495,4980
1.00E+12,310,225,5,4500,675,3,12825,13500
1.00E+12,310,475,9.7,4880,475,1,4405,4880
2.10E+12,200,1644,24,6850,4932,3,15618,20550
1.00E+12,310,433,7.9,5480,433,1,5047,5480
8328977,310,76,7.8,980,76,1,904,980
1.00E+12,100,95,7.9,1200,95,1,1105,1200
1.00E+12,100,237,7.9,3000,237,1,2763,3000
1.00E+12,501,394,7.9,4980,394,1,4586,4980
1.00E+12,501,433,7.9,5480,433,1,5047,5480
1.00E+12,200,1260,7,18000,1260,1,16740,18000
1.00E+12,200,190576,17.2,1108000,190576,1,917424,1108000
10008971,310,185,6.9,2680,370,2,4990,5360
1.00E+12,310,412,6.9,5980,412,1,5568,5980
1.00E+12,340,698,7,9980,698,1,9282,9980
8612764,340,138,7,1980,138,1,1842,1980
1.00E+12,340,243,7,3480,243,1,3237,3480
8454765,310,255,8.8,2900,255,1,2645,2900
1.00E+12,310,261,8.8,2980,261,1,2719,2980
1.00E+12,310,356,8.8,4050,356,1,3694,4050
1.00E+12,310,437,8.8,4980,874,2,9086,9960
8454765,100,255,8.8,2900,255,1,2645,2900
1.00E+12,100,243,8.7,2780,243,1,2537,2780
1.00E+12,100,437,8.8,4980,874,2,9086,9960
1.00E+12,100,437,8.8,4980,874,2,9086,9960
1.00E+12,100,147,8.8,1680,147,1,1533,1680
1.00E+12,310,3240,32.7,9900,6480,2,13320,19800
1.00E+12,310,1628,11.6,13980,1628,1,12352,13980
1.00E+12,601,335,11.6,2880,335,1,2545,2880
1.00E+12,310,1588,10,15900,1588,1,14312,15900
1.00E+12,200,131,11.9,1100,262,2,1938,2200
1.00E+12,310,1590,10,15900,1590,1,14310,15900
1.00E+12,310,358,10,3580,358,1,3222,3580
1.00E+12,310,990,10,9900,1980,2,17820,19800
2.10E+12,310,2787,18.8,14800,5573,2,24027,29600
1.00E+12,240,1527,14.2,10780,1527,1,9253,10780
1.00E+12,310,395,5,7900,395,1,7505,7900
10717442,310,194,5,3880,776,4,14744,15520
6615474,310,217,8.5,2560,217,1,2343,2560
1.00E+12,310,75,8.5,880,374,5,4026,4400
1.00E+12,240,676,20,3380,1352,2,5408,6760
1.00E+12,310,130,8.2,1580,130,1,1450,1580
1.00E+12,310,304,8.3,3680,304,1,3376,3680
1.00E+12,310,453,8.3,5480,453,1,5027,5480
1.00E+12,200,51500,12.4,415000,51500,1,363500,415000
8568265,310,275,5,5500,550,2,10450,11000
4241023,200,13775,14.5,95000,13775,1,81225,95000
1.00E+12,310,5980,20,29900,5980,1,23920,29900
7463358,511,1633,33.3,4900,4900,3,9800,14700
1.00E+12,310,519,7,7420,519,1,6901,7420
1.00E+12,310,2233,7,31900,4466,2,59334,63800
8333662,240,528,17.1,3080,1056,2,5104,6160
8333662,310,528,17.1,3080,1056,2,5104,6160
1.00E+12,310,544,6.9,7900,544,1,7356,7900
1.00E+12,310,575,5,11500,575,1,10925,11500
2.10E+12,310,236,9.5,2480,236,1,2244,2480
2.10E+12,310,340,9.5,3580,680,2,6480,7160
2.10E+12,310,1612,9.6,16800,1612,1,15188,16800
2.10E+12,310,414,9.5,4350,414,1,3936,4350
1.00E+12,310,331,9.5,3480,331,1,3149,3480
6617477,310,245,9.5,2580,245,1,2335,2580
1.00E+12,310,378,9.5,3980,378,1,3602,3980
1.00E+12,310,1324,29.6,4480,1324,1,3156,4480
1.00E+12,310,260,29.5,880,260,1,620,880
1.00E+12,310,1738,29.6,5880,1738,1,4142,5880
1.00E+12,200,6868,20.2,34000,6868,1,27132,34000
1.00E+12,200,10500,15,70000,10500,1,59500,70000
1.00E+12,200,4950,15,33000,4950,1,28050,33000
1.00E+12,200,4277,23.5,18200,4277,1,13923,18200
,,,,,,,,
1.00E+12,200,13370,2.9,455000,13370,1,441630,455000
2.10E+12,310,2252,25.6,8800,4504,2,13096,17600
1.00E+12,310,233,8.1,2880,466,2,5294,5760
6824161,310,330,8.1,4080,330,1,3750,4080
10369034,310,97,8.1,1200,194,2,2206,2400
1.00E+12,310,322,8.1,3980,322,1,3658,3980
1.00E+12,310,184,8.1,2280,184,1,2096,2280
1.00E+12,300,2000,10,19980,4000,2,35960,39960
1.00E+12,310,1390,10,13900,1390,1,12510,13900
2.10E+12,310,217,9.5,2280,217,1,2063,2280
7501736,310,455,7,6500,455,1,6045,6500
2.10E+12,310,383,7,5480,383,1,5097,5480
1.00E+12,200,3240,10,32400,3240,1,29160,32400
1.00E+12,310,425,5,8500,850,2,16150,17000
1.00E+12,310,1367,9.8,13980,1367,1,12613,13980
1.00E+12,310,487,9.8,4980,487,1,4493,4980
8988448,310,917,9.8,9380,917,1,8463,9380
1.00E+12,310,4142,29.8,13900,8284,2,19516,27800
1.00E+12,310,490,10,4900,490,1,4410,4900
1.00E+12,310,299,5,5980,598,2,11362,11960
1.00E+12,310,156,7.9,1980,156,1,1824,1980
1.00E+12,310,2206,27.6,8000,2206,1,5794,8000
6617825,310,546,14,3900,546,1,3354,3900
1.00E+12,310,1246,14,8900,1246,1,7654,8900
1.00E+12,205,2206,27.6,8000,2206,1,5794,8000
1.00E+12,205,2758,27.6,10000,2758,1,7242,10000
1.00E+12,200,19270,23.5,82000,19270,1,62730,82000
1.00E+12,310,89,7,1280,89,1,1191,1280
2.10E+12,310,208,8.7,2380,208,1,2172,2380
7690680,310,225,8.7,2580,225,1,2355,2580
7695432,310,160,10,1600,160,1,1440,1600
1.00E+12,200,2772,28,9900,2772,1,7128,9900
1.00E+12,200,2702,20.9,12900,5404,2,20396,25800
1.00E+12,200,9450,9,105000,9450,1,95550,105000
1.00E+12,310,133,4.5,2980,133,1,2847,2980
1.00E+12,310,106,4.5,2380,106,1,2274,2380
1.00E+12,310,70,4.4,1580,70,1,1510,1580
1.00E+12,310,536,4.5,11980,536,1,11444,11980
1.00E+12,310,715,4.5,15980,715,1,15265,15980
10041281,310,178,4.5,3980,178,1,3802,3980
10716350,310,903,7,12900,903,1,11997,12900
1.00E+12,200,4299,9.7,44100,4299,1,39801,44100
2.10E+12,200,1807,11.4,15800,5422,3,41978,47400
1.00E+12,200,3600,5,72000,3600,1,68400,72000
1.00E+12,300,496,20,2480,496,1,1984,2480
1.00E+12,310,150,5,3000,150,1,2850,3000
9603520,310,273,7,3900,273,1,3627,3900
2.10E+12,310,274,5,5480,1370,5,26030,27400
1.00E+12,200,8120,20.5,39690,8120,1,31570,39690
1.00E+12,310,518,7,7400,518,1,6882,7400
1.00E+12,310,483,7,6900,483,1,6417,6900
1.00E+12,310,329,7,4700,329,1,4371,4700
1.00E+12,310,149,5,2980,149,1,2831,2980
2.10E+12,310,1145,14.5,7900,1145,1,6755,7900
1.00E+12,200,2850,19,15000,2850,1,12150,15000
1.00E+12,310,49600,25.1,198000,49600,1,148400,198000
2.10E+12,205,1326,25.6,5180,1326,1,3854,5180
1.00E+12,200,6235,14.5,43000,6235,1,36765,43000
1.00E+12,200,3784,17.2,22000,3784,1,18216,22000
7680857,310,179,9.2,1950,1071,6,10629,11700
2.10E+12,310,181,9.1,1980,543,3,5397,5940
2.10E+12,310,209,9.2,2280,627,3,6213,6840
1.00E+12,310,339,9.2,3700,1017,3,10083,11100
7152284,340,145,7,2080,145,1,1935,2080
8311805,310,185,7.8,2380,185,1,2195,2380
7095585,310,388,7.8,4980,775,2,9185,9960
2.10E+12,200,1870,17,11000,1870,1,9130,11000
1.00E+12,300,32270,23.3,138400,32270,1,106130,138400
7558719,310,820,10,8200,820,1,7380,8200
1.00E+12,310,1680,10,16800,1680,1,15120,16800
2.10E+12,310,595,5,11900,1190,2,22610,23800
2.10E+12,310,324,5,6480,324,1,6156,6480
2.10E+12,310,318,10,3180,318,1,2862,3180
7234767,310,204,5,4080,408,2,7752,8160
2.10E+12,310,483,7,6900,966,2,12834,13800
2.10E+12,310,1316,7,18800,2632,2,34968,37600
1.00E+12,310,99,5,1980,99,1,1881,1980
1.00E+12,310,4900,10,49000,4900,1,44100,49000
7104921,310,559,10,5590,1118,2,10062,11180
8432599,310,495,10,4950,495,1,4455,4950
1.00E+12,310,300,10,3000,600,2,5400,6000
7688234,310,415,10,4150,415,1,3735,4150
1.00E+12,240,1365,35,3900,1365,1,2535,3900
1.00E+12,300,43750,7,625000,43750,1,581250,625000
1.00E+12,340,1064,9.9,10780,1064,1,9716,10780
7073945,240,1794,46,3900,3588,2,4212,7800
1.00E+12,310,7488,37.6,19900,14976,2,24824,39800
1.00E+12,205,2565,19,13500,5130,2,21870,27000
8624384,310,306,7,4380,306,1,4074,4380
7688177,310,245,7,3500,245,1,3255,3500
8983477,310,379,8.3,4580,379,1,4201,4580
6829364,240,2458,33,7450,105694,43,214656,320350
2.10E+12,200,1448,26.4,5480,1448,1,4032,5480
2.10E+12,200,3318,28,11850,3318,1,8532,11850
1.00E+12,500,6630,17.5,37800,6630,1,31170,37800
1.00E+12,200,1930,11.1,17400,1930,1,15470,17400
1.00E+12,310,648,10,6480,648,1,5832,6480
2.10E+12,200,1972,37,5330,5916,3,10074,15990
6942752,310,407,9,4500,407,1,4093,4500
1.00E+12,310,12046,28.7,41900,36138,3,89562,125700
1.00E+12,310,945,5,18900,5670,6,107730,113400
1.00E+12,310,1278,17.1,7480,1278,1,6202,7480
8562095,310,298,7.9,3780,298,1,3482,3780
1.00E+12,240,1771,16.4,10780,1771,1,9009,10780
1.00E+12,240,11013,43,25600,33040,3,43760,76800
1.00E+12,200,600,10,6000,600,1,5400,6000
1.00E+12,300,2000,25.1,7980,4000,2,11960,15960
1.00E+12,310,104,6.2,1680,104,1,1576,1680
7150833,310,310,6.2,4990,310,1,4680,4990
6610869,310,152,6.2,2450,152,1,2298,2450
1.00E+12,310,241,6.2,3880,241,1,3639,3880
1.00E+12,310,1886,9.9,18980,1886,1,17094,18980
1.00E+12,310,524,9.9,5280,524,1,4756,5280
8302063,310,160,5,3200,320,2,6080,6400
10220255,340,2060,5.4,37800,2060,1,35740,37800
1.00E+12,310,725,14.5,5000,725,1,4275,5000
1.00E+12,200,580,14.5,4000,1740,3,10260,12000
1.00E+12,200,725,14.5,5000,725,1,4275,5000
1.00E+12,300,5824,20.8,28000,5824,1,22176,28000
1.00E+12,310,21952,28,78400,65856,3,169344,235200
1.00E+12,205,1273,53.5,2380,3819,3,3321,7140
1.00E+12,310,490,7,7000,1470,3,19530,21000
7471752,310,525,7,7500,1575,3,20925,22500
9014185,511,2054,53.5,3840,12324,6,10716,23040
2.10E+12,310,348,7,4980,1044,3,13896,14940
6611114,310,298,10,2980,298,1,2682,2980
1.00E+12,310,7254,14.3,50556,7254,1,43302,50556
1.00E+12,200,7254,14.3,50556,7254,1,43302,50556
1.00E+12,200,250,3.2,7800,250,1,7550,7800
1.00E+12,200,65830,14.6,450000,65830,1,384170,450000
2828461,100,2970,3,99000,2970,1,96030,99000
1.00E+12,340,693,7,9900,693,1,9207,9900
6611230,310,149,5,2980,447,3,8493,8940
7271359,310,159,8.9,1780,317,2,3243,3560
8225926,310,312,8.9,3500,312,1,3188,3500
1.00E+12,200,90,6,1500,450,5,7050,7500
1.00E+12,200,1800,15,12000,1800,1,10200,12000
1.00E+12,310,2090,19,11000,2090,1,8910,11000
1.00E+12,310,478,10,4780,478,1,4302,4780
1.00E+12,310,898,10,8980,1796,2,16164,17960
1.00E+12,310,248,10,2480,248,1,2232,2480
1.00E+12,310,566,19,2980,566,1,2414,2980
9707917,100,432,14.5,2980,432,1,2548,2980
1.00E+12,100,920,14.5,6350,1840,2,10860,12700
7419878,100,756,19,3980,756,1,3224,3980
1.00E+12,310,1831,18.3,9980,5492,3,24448,29940
1.00E+12,200,5090,10,50900,5090,1,45810,50900
2.10E+12,310,300,5,6000,300,1,5700,6000
1.00E+12,340,208,7,2980,416,2,5544,5960
8488475,340,490,7,7000,490,1,6510,7000
1.00E+12,310,890,10,8900,1780,2,16020,17800
2.10E+12,200,722,19,3800,1444,2,6156,7600
2.10E+12,310,1412,18.9,7480,1412,1,6068,7480
1.00E+12,310,294,9.9,2980,294,1,2686,2980
1.00E+12,310,343,9.9,3480,343,1,3137,3480
1.00E+12,310,490,10,4900,1470,3,13230,14700
1.00E+12,310,590,10,5900,590,1,5310,5900
1.00E+12,310,1000,14.5,6900,1000,1,5900,6900
1.00E+12,500,3355,11.6,28800,6710,2,50890,57600
1.00E+12,310,164880,20.6,800000,164880,1,635120,800000
1.00E+12,100,4715,13.5,34800,9430,2,60170,69600
1.00E+12,310,369,7,5280,369,1,4911,5280
1.00E+12,310,170,8.6,1980,170,1,1810,1980
2.10E+12,310,617,8.6,7180,617,1,6563,7180
1.00E+12,310,557,8.6,6480,557,1,5923,6480
1.00E+12,310,1797,8.6,20800,1797,1,19003,20800
7469562,310,706,8.8,7980,706,1,7274,7980
1.00E+12,501,2285,8.9,25800,2285,1,23515,25800
1.00E+12,501,121,8.8,1380,121,1,1259,1380
1.00E+12,310,930,8.9,10480,930,1,9550,10480
1.00E+12,200,4788,24,19950,4788,1,15162,19950
2.10E+12,200,1000,7.2,13800,1000,1,12800,13800
1.00E+12,310,115,9.2,1240,229,2,2251,2480
1.00E+12,310,282,4.7,5980,563,2,11397,11960
1.00E+12,310,422,4.7,8980,422,1,8558,8980
1.00E+12,310,564,4.7,11980,564,1,11416,11980
2.10E+12,310,1824,33.3,5480,1824,1,3656,5480
10008970,310,154,4.7,3280,154,1,3126,3280
6620568,310,618,10,6180,618,1,5562,6180
1.00E+12,310,588,7,8400,588,1,7812,8400
1.00E+12,310,898,10,8980,898,1,8082,8980
1.00E+12,200,18475,10.9,169500,18475,1,151025,169500
1.00E+12,310,1000,6.9,14500,10000,10,135000,145000
2.10E+12,310,187,7,2680,187,1,2493,2680
1.00E+12,310,499,5,9980,998,2,18962,19960
1.00E+12,310,575,9.7,5900,2300,4,21300,23600
1.00E+12,310,68,6.9,980,136,2,1824,1960
2.10E+12,601,291,11.6,2500,291,1,2209,2500
9599700,310,349,5,6980,349,1,6631,6980
1.00E+12,200,9600,20,48000,9600,1,38400,48000
1.00E+12,310,118,10,1180,118,1,1062,1180
1.00E+12,240,975,25,3900,1950,2,5850,7800
1.00E+12,310,20210,23.5,86000,20210,1,65790,86000
7446282,310,76,7.6,1000,152,2,1848,2000
,,,,,,,,
6610869,240,455,18.6,2450,909,2,3991,4900
1.00E+12,310,407,9.5,4280,407,1,3873,4280
2.10E+12,310,112,9.5,1180,224,2,2136,2360
1.00E+12,310,227,9.5,2390,681,3,6489,7170
8118091,310,188,9.5,1980,188,1,1792,1980
2.10E+12,200,645,18.5,3480,645,1,2835,3480
1.00E+12,300,3500,41.3,8480,3500,1,4980,8480
1.00E+12,200,7730,9.8,79000,7730,1,71270,79000
1.00E+12,500,7730,9.8,79000,7730,1,71270,79000
1.00E+12,310,1732,19.2,9000,1732,1,7268,9000
1.00E+12,310,449,5,8980,449,1,8531,8980
1.00E+12,100,5234,14.5,36100,5234,1,30866,36100
1.00E+12,310,3792,9.7,38900,3792,1,35108,38900
1.00E+12,310,3940,13.7,28800,7880,2,49720,57600
1.00E+12,200,2441,10.9,22400,2441,1,19959,22400
1.00E+12,310,209,5,4180,209,1,3971,4180
1.00E+12,310,658,16.5,3980,2632,4,13288,15920
1.00E+12,310,250,7.2,3480,250,1,3230,3480
2.10E+12,310,801,23,3480,801,1,2679,3480
2.10E+12,100,801,23,3480,801,1,2679,3480
8114091,310,184,5,3680,184,1,3496,3680
7411087,310,174,5,3480,174,1,3306,3480
1.00E+12,310,478,6.9,6900,478,1,6422,6900
1.00E+12,310,345,6.9,4980,345,1,4635,4980
1.00E+12,310,969,6.9,13980,969,1,13011,13980
1.00E+12,310,628,7,8980,628,1,8352,8980
2.10E+12,310,7080,20.3,34800,14160,2,55440,69600
1.00E+12,200,1650,15,11000,1650,1,9350,11000
1.00E+12,100,798,10,7980,798,1,7182,7980
1.00E+12,200,1111,3,37050,2222,2,71878,74100
2.10E+12,310,1480,10,14800,2960,2,26640,29600
1.00E+12,310,416,7,5950,832,2,11068,11900
6612008,310,238,10,2380,238,1,2142,2380
1.00E+12,310,860,9,9600,860,1,8740,9600
1.00E+12,310,2228,9,24800,2228,1,22572,24800
1.00E+12,601,731,11.6,6280,731,1,5549,6280
2.10E+12,310,1165,33.5,3480,4660,4,9260,13920
2.10E+12,310,390,5,7800,780,2,14820,15600
1.00E+12,310,3320,14.5,22900,13280,4,78320,91600
6613867,310,228,10,2280,456,2,4104,4560
1.00E+12,200,10500,10,105000,10500,1,94500,105000
1.00E+12,200,14065,29.8,47200,14065,1,33135,47200
2.10E+12,310,264,10,2640,3168,12,28512,31680
1.00E+12,310,52,8,650,1244,24,14356,15600
1.00E+12,310,142,11.1,1280,426,3,3414,3840
1.00E+12,310,1198,11.1,10780,1198,1,9582,10780
1.00E+12,240,1200,11.1,10780,1200,1,9580,10780
2.10E+12,601,1737,14.5,11980,1737,1,10243,11980
2.10E+12,310,790,10,7900,790,1,7110,7900
1.00E+12,310,149,5,2980,149,1,2831,2980
1.00E+12,200,37527,26.2,143000,37527,1,105473,143000
1.00E+12,500,24117,28.7,84150,24117,1,60033,84150
7050065,310,374,7,5350,374,1,4976,5350
1.00E+12,300,39170,20.9,187000,39170,1,147830,187000
6609555,310,201,10.9,1850,402,2,3298,3700
2.10E+12,310,651,10.9,5980,1302,2,10658,11960
1.00E+12,310,149,10.8,1380,447,3,3693,4140
1.00E+12,200,6124,17.3,35300,6124,1,29176,35300
1.00E+12,310,85,9.4,900,425,5,4075,4500
2.10E+12,200,2219,16,13900,2219,1,11681,13900
1.00E+12,310,1790,10,17900,1790,1,16110,17900
1.00E+12,200,2160,9,24000,2160,1,21840,24000
1.00E+12,310,5538,9.7,56810,5538,1,51272,56810
1.00E+12,310,99,5,1980,198,2,3762,3960
1.00E+12,310,3230,54.7,5900,6459,2,5341,11800
1.00E+12,310,203,9.4,2150,203,1,1947,2150
1.00E+12,310,138,3.5,3980,138,1,3842,3980
1.00E+12,310,51,3.4,1480,51,1,1429,1480
1.00E+12,310,2562,8.4,30500,2562,1,27938,30500
1.00E+12,310,21,3.5,600,83,4,2317,2400
1.00E+12,310,69,3.5,1980,69,1,1911,1980
10717442,310,135,3.5,3880,135,1,3745,3880
2.10E+12,310,184,3.5,5280,184,1,5096,5280
1.00E+12,310,116,9.7,1200,116,1,1084,1200
10732906,310,251,7.2,3480,251,1,3229,3480
1.00E+12,310,208,7,2980,208,1,2772,2980
1.00E+12,310,698,10,6980,698,1,6282,6980
1.00E+12,310,158,10,1580,158,1,1422,1580
1.00E+12,310,198,10,1980,198,1,1782,1980
2.10E+12,240,178,10,1780,356,2,3204,3560
1.00E+12,200,7790,19,41000,7790,1,33210,41000
1.00E+12,200,1800,5,36000,1800,1,34200,36000
1.00E+12,310,392,6.6,5980,1176,3,16764,17940
2.10E+12,310,1044,6.6,15900,3132,3,44568,47700
1.00E+12,200,5900,10,59000,5900,1,53100,59000
1.00E+12,310,118,10,1180,236,2,2124,2360
1.00E+12,100,157,2,7880,157,1,7723,7880
1.00E+12,100,449,5,8980,449,1,8531,8980
7899562,310,396,36.7,1080,1188,3,2052,3240
1.00E+12,310,872,9.8,8880,872,1,8008,8880
1.00E+12,310,458,10,4600,458,1,4142,4600
2.10E+12,310,167,9.9,1680,167,1,1513,1680
1.00E+12,200,7470,20.2,37000,7470,1,29530,37000
1.00E+12,200,6990,19,36800,6990,1,29810,36800
1.00E+12,310,243,7,3480,243,1,3237,3480
8631820,310,908,7,12980,908,1,12072,12980
1.00E+12,310,47,6.9,680,470,10,6330,6800
8425071,310,498,10,4980,498,1,4482,4980
1.00E+12,200,13406,17,79000,13406,1,65594,79000
1.00E+12,500,13406,17,79000,13406,1,65594,79000
1.00E+12,310,1111,1.4,82000,1111,1,80889,82000
1.00E+12,310,273,7,3900,273,1,3627,3900
6609525,310,64,5,1280,128,2,2432,2560
1.00E+12,205,800,28.8,2780,800,1,1980,2780
1.00E+12,310,140,9.7,1450,140,1,1310,1450
1.00E+12,100,124,9.7,1280,248,2,2312,2560
1.00E+12,100,339,9.7,3480,339,1,3141,3480
1.00E+12,310,500,5,10000,500,1,9500,10000
7333432,310,195,5,3900,195,1,3705,3900
1.00E+12,500,3568,14.4,24700,3568,1,21132,24700
1.00E+12,511,3478,53.5,6500,6955,2,6045,13000
2.10E+12,310,598,10,5980,5980,10,53820,59800
2.10E+12,310,250,10,2500,1000,4,9000,10000
1.00E+12,310,210,7,3000,420,2,5580,6000
1.00E+12,310,79,5,1580,79,1,1501,1580
1.00E+12,310,99,5,1980,297,3,5643,5940
1.00E+12,310,192,5,3840,192,1,3648,3840
1.00E+12,310,164,5,3280,164,1,3116,3280
1.00E+12,310,748,10,7480,1496,2,13464,14960
2.10E+12,310,178,9,1980,178,1,1802,1980
1.00E+12,300,12870,16.3,79000,12870,1,66130,79000
1.00E+12,310,13617,20.9,65000,13617,1,51383,65000
10624,310,7172,16.3,44000,7172,1,36828,44000
1.00E+12,200,3087,10,30870,3087,1,27783,30870
10354310,310,268,10,2680,1340,5,12060,13400
2.10E+12,310,458,10,4580,2290,5,20610,22900
1.00E+12,200,1059,7.8,13500,1059,1,12441,13500
8075882,310,321,7.1,4500,321,1,4179,4500
1.00E+12,310,234,7.1,3280,234,1,3046,3280
10229292,310,284,7.1,3980,284,1,3696,3980
1.00E+12,200,16910,19,89000,16910,1,72090,89000
1.00E+12,310,1416,9,15800,1416,1,14384,15800
1.00E+12,310,222,9,2480,222,1,2258,2480
2.10E+12,310,148,10,1480,148,1,1332,1480
1.00E+12,310,1896,19,9980,3792,2,16168,19960
1.00E+12,310,523,7,7480,523,1,6957,7480
1.00E+12,310,208,7,2980,208,1,2772,2980
1.00E+12,310,68,6.9,980,68,1,912,980
8228112,511,2476,55.9,4430,4952,2,3908,8860
1.00E+12,100,5049,51,9900,5049,1,4851,9900
1.00E+12,500,24560,22.1,111200,24560,1,86640,111200
1.00E+12,200,490,5,9800,980,2,18620,19600
1.00E+12,200,560,2.2,25500,560,1,24940,25500
1.00E+12,200,1100,6.7,16500,1100,1,15400,16500
1.00E+12,601,89,5,1780,89,1,1691,1780
1.00E+12,601,89,5,1780,89,1,1691,1780
1.00E+12,310,349,5,6980,349,1,6631,6980
1.00E+12,240,2030,35,5800,4060,2,7540,11600
1.00E+12,310,63,7.2,880,316,5,4084,4400
8634541,310,393,7.2,5480,393,1,5087,5480
2.10E+12,310,233,11.8,1980,233,1,1747,1980
2.10E+12,310,145,11.7,1240,145,1,1095,1240
1092664,310,9047,19.2,47000,9047,1,37953,47000
1.00E+12,500,31915,12.7,251300,31915,1,219385,251300
1.00E+12,310,1113,7,15900,1113,1,14787,15900
8646828,310,698,7,9980,698,1,9282,9980
1.00E+12,310,698,7,9980,698,1,9282,9980
1.00E+12,340,1735,11.6,14900,6940,4,52660,59600
2.10E+12,310,4273,24,17800,4273,1,13527,17800
8090941,310,411,8.6,4780,411,1,4369,4780
2.10E+12,200,4273,24,17800,4273,1,13527,17800
6609553,310,95,10,950,380,4,3420,3800
6834904,310,134,5,2680,134,1,2546,2680
1.00E+12,310,193,9.7,1980,1158,6,10722,11880
1.00E+12,100,193,9.7,1980,1158,6,10722,11880
1.00E+12,100,287,14.5,1980,287,1,1693,1980
7022305,240,2382,45.8,5200,2382,1,2818,5200
1.00E+12,310,774,9.7,7980,774,1,7206,7980
1.00E+12,310,4002,53.5,7480,16006,4,13914,29920
1.00E+12,310,248,10,2480,248,1,2232,2480
1.00E+12,200,5725,23,24900,5725,1,19175,24900
1.00E+12,310,790,10,7900,790,1,7110,7900
2.10E+12,310,1832,29.4,6225,3664,2,8786,12450
2.10E+12,310,315,11.8,2680,630,2,4730,5360
1.00E+12,511,1969,55,3580,23628,12,19332,42960
1.00E+12,205,14127,39.3,35980,42382,3,65558,107940
1.00E+12,200,3089,20.6,15000,9267,3,35733,45000
1.00E+12,340,3089,20.6,15000,9267,3,35733,45000
1.00E+12,310,1029,9.9,10380,1029,1,9351,10380
2.10E+12,340,455,7,6500,455,1,6045,6500
1.00E+12,310,365,9.5,3840,1095,3,10425,11520
1.00E+12,310,941,9.5,9900,941,1,8959,9900
2.10E+12,310,532,4.1,12980,532,1,12448,12980
1.00E+12,310,73,4.1,1780,73,1,1707,1780
2.10E+12,310,1625,23.3,6980,1625,1,5355,6980
2.10E+12,310,607,4.1,14800,607,1,14193,14800
1.00E+12,310,477,4.2,11400,953,2,21847,22800
2.10E+12,200,1625,23.3,6980,1625,1,5355,6980
1.00E+12,200,20350,20.5,99400,20350,1,79050,99400
1.00E+12,200,1440,18,8000,1440,1,6560,8000
2.10E+12,310,398,10,3980,796,2,7164,7960
1.00E+12,310,383,7,5480,383,1,5097,5480
2.10E+12,310,243,7,3480,243,1,3237,3480
1.00E+12,310,577,7.2,7980,1153,2,14807,15960
1.00E+12,310,1268,10,12680,3804,3,34236,38040
1.00E+12,200,4400,10,44000,4400,1,39600,44000
1.00E+12,240,2311,42.2,5480,2311,1,3169,5480
1.00E+12,240,1476,42.2,3500,1476,1,2024,3500
1.00E+12,310,1476,42.2,3500,1476,1,2024,3500
2.10E+12,310,613,12.8,4780,613,1,4167,4780
2.10E+12,310,2424,12.8,18900,2424,1,16476,18900
1.00E+12,310,1898,42.2,4500,1898,1,2602,4500
1.00E+12,100,1898,42.2,4500,1898,1,2602,4500
1.00E+12,100,1898,42.2,4500,1898,1,2602,4500
7051960,100,338,17.4,1940,675,2,3205,3880
1.00E+12,200,9480,19,49900,9480,1,40420,49900
1.00E+12,601,89,5,1780,89,1,1691,1780
9669954,340,266,5.3,4980,532,2,9428,9960
1.00E+12,200,2235,15,14900,2235,1,12665,14900
1.00E+12,200,5250,15,35000,5250,1,29750,35000
1.00E+12,200,1329,10,13298,1329,1,11969,13298
1.00E+12,310,138,7,1980,138,1,1842,1980
6615155,310,197,9.9,1980,197,1,1783,1980
1.00E+12,601,1162,11.6,9980,1162,1,8818,9980
6613868,310,114,5,2280,342,3,6498,6840
6609453,205,1416,24,5900,1416,1,4484,5900
1.00E+12,200,2730,10,27300,2730,1,24570,27300
1.00E+12,310,513,19,2700,513,1,2187,2700
1.00E+12,310,343,7,4900,686,2,9114,9800
1.00E+12,310,320,7,4580,960,3,12780,13740
8632269,310,487,9.6,5080,487,1,4593,5080
8989814,310,449,9.6,4680,449,1,4231,4680
1.00E+12,310,3188,6.3,50300,3188,1,47112,50300
6610869,310,154,6.3,2450,154,1,2296,2450
1.00E+12,200,15200,19.2,79000,15200,1,63800,79000
1.00E+12,500,15200,19.2,79000,15200,1,63800,79000
1.00E+12,200,1030,8,12900,1030,1,11870,12900
1.00E+12,310,192,9.7,1980,192,1,1788,1980
7480109,310,145,9.7,1500,145,1,1355,1500
6616801,310,289,9.7,2980,289,1,2691,2980
1.00E+12,310,192,9.7,1980,192,1,1788,1980
1.00E+12,500,3611,11.6,31000,14444,4,109556,124000
1.00E+12,310,224,5,4480,224,1,4256,4480
1.00E+12,100,2136,16.1,13300,2136,1,11164,13300
1.00E+12,501,1590,16.1,9900,1590,1,8310,9900
1.00E+12,310,1010,10,10100,1010,1,9090,10100
6820123,340,315,10,3150,630,2,5670,6300
1.00E+12,310,173,7,2480,346,2,4614,4960
1.00E+12,310,1392,10,13980,1392,1,12588,13980
2.10E+12,310,90,5,1800,90,1,1710,1800
1.00E+12,310,1366,10.5,12980,1366,1,11614,12980
1.00E+12,310,167,5.8,2880,167,1,2713,2880
1.00E+12,240,373,15.2,2450,1120,3,6230,7350
1.00E+12,310,378,5.8,6500,378,1,6122,6500
1.00E+12,511,5445,55,9900,10890,2,8910,19800
8023190,310,1160,10,11600,1160,1,10440,11600
1.00E+12,310,198,10,1980,198,1,1782,1980
1.00E+12,310,10000,8.3,119990,10000,1,109990,119990
1.00E+12,240,12438,41.7,29800,24876,2,34724,59600
7183572,310,614,9.5,6480,614,1,5866,6480
1.00E+12,310,559,9.5,5900,559,1,5341,5900
1.00E+12,310,683,14,4880,683,1,4197,4880
1.00E+12,310,7149,15.9,45000,7149,1,37851,45000
1.00E+12,200,944,15.9,5950,944,1,5006,5950
1.00E+12,200,944,15.9,5950,944,1,5006,5950
8531580,310,607,7.6,7980,607,1,7373,7980
7909931,310,192,7.6,2530,192,1,2338,2530
1.00E+12,310,363,7.6,4780,363,1,4417,4780
2.10E+12,200,5753,38.6,14900,5753,1,9147,14900
1.00E+12,310,1737,14.5,11980,1737,1,10243,11980
9040266,100,2099,14.5,14480,2099,1,12381,14480
10354262,100,432,14.5,2980,432,1,2548,2980
1.00E+12,310,257,7,3680,257,1,3423,3680
1.00E+12,310,1786,9.9,17980,1786,1,16194,17980
10222455,310,1150,9.9,11580,1150,1,10430,11580
1.00E+12,340,68,6.9,980,68,1,912,980
8889750,310,623,7,8900,623,1,8277,8900
2.10E+12,205,616,20,3080,616,1,2464,3080
8068394,310,98,10,980,98,1,882,980
1.00E+12,310,498,10,4980,996,2,8964,9960
1.00E+12,310,130,10,1300,260,2,2340,2600
1.00E+12,310,348,10,3480,348,1,3132,3480
1.00E+12,310,1390,10,13900,1390,1,12510,13900
1.00E+12,310,431,6.2,6980,431,1,6549,6980
1.00E+12,310,456,6.2,7380,456,1,6924,7380
10008970,310,202,6.2,3280,202,1,3078,3280
1.00E+12,310,97,6.1,1580,97,1,1483,1580
1.00E+12,310,153,6.2,2480,153,1,2327,2480
1.00E+12,310,338,6.2,5480,338,1,5142,5480
1.00E+12,310,524,6.2,8480,524,1,7956,8480
1.00E+12,310,493,6.2,7980,493,1,7487,7980
1.00E+12,310,493,6.2,7980,493,1,7487,7980
6829364,310,745,10,7450,1490,2,13410,14900
7639225,310,498,10,4980,498,1,4482,4980
1.00E+12,200,4256,19,22400,4256,1,18144,22400
1.00E+12,601,299,5,5980,299,1,5681,5980
1.00E+12,200,7400,5,148000,7400,1,140600,148000
1.00E+12,310,414,4.9,8480,414,1,8066,8480
8633455,310,389,4.9,7980,389,1,7591,7980
1.00E+12,511,386,35.8,1080,2317,6,4163,6480
1.00E+12,240,138,23.1,600,1800,13,6000,7800
1.00E+12,310,178,3.6,4880,178,1,4702,4880
1.00E+12,310,338,3.8,8900,338,1,8562,8900
7296003,310,386,35.7,1080,1158,3,2082,3240
1.00E+12,500,7610,17.5,43400,7610,1,35790,43400
1.00E+12,340,336,4.9,6800,336,1,6464,6800
8076933,310,101,7,1450,303,3,4047,4350
1.00E+12,310,44,5,880,44,1,836,880
1.00E+12,310,1462,5.9,24900,1462,1,23438,24900
2.10E+12,310,873,5.9,14800,1745,2,27855,29600
1.00E+12,340,1296,20,6480,3888,3,15552,19440
1.00E+12,310,299,5,5980,299,1,5681,5980
1.00E+12,200,973,7,13900,973,1,12927,13900
1.00E+12,310,208,7,2980,208,1,2772,2980
2.10E+12,310,458,10,4580,916,2,8244,9160
2.10E+12,200,369,20.5,1800,369,1,1431,1800
1.00E+12,200,1580,20,7900,1580,1,6320,7900
7518252,310,163,7.4,2200,326,2,4074,4400
1.00E+12,310,989,9.9,10000,989,1,9011,10000
1.00E+12,310,2560,9.9,25800,2560,1,23240,25800
2.10E+12,310,1592,22.8,6980,3183,2,10777,13960
2.10E+12,310,349,5,6980,698,2,13262,13960
2.10E+12,200,3827,43,8900,3827,1,5073,8900
1.00E+12,310,3265,41.9,7800,3265,1,4535,7800
10355529,310,386,8.9,4320,386,1,3934,4320
1.00E+12,310,356,8.9,3980,356,1,3624,3980
2.10E+12,310,132,8.9,1480,132,1,1348,1480
7580677,310,266,8.9,2980,266,1,2714,2980
1.00E+12,310,251,6.8,3680,251,1,3429,3680
1.00E+12,310,401,6.8,5880,401,1,5479,5880
1.00E+12,310,33542,20,167300,33542,1,133758,167300
1.00E+12,200,1101,8,13770,1101,1,12669,13770
1.00E+12,100,298,10,2980,298,1,2682,2980
1.00E+12,100,349,5,6980,349,1,6631,6980
2.10E+12,100,320,5,6400,320,1,6080,6400
1.00E+12,100,549,5,10980,549,1,10431,10980
2.10E+12,100,104,5,2080,104,1,1976,2080
2.10E+12,310,368,20.4,1800,368,1,1432,1800
2.10E+12,310,1849,14.4,12800,1849,1,10951,12800
1.00E+12,340,208,7,2980,208,1,2772,2980
1.00E+12,200,1650,15,11000,1650,1,9350,11000
1.00E+12,340,1036,7,14800,1036,1,13764,14800
6916804,310,632,9.1,6980,632,1,6348,6980
1.00E+12,310,1183,7,16900,1183,1,15717,16900
7465989,310,203,7.8,2600,203,1,2397,2600
2.10E+12,310,357,7.8,4580,357,1,4223,4580
1.00E+12,300,27170,23.7,114480,27170,1,87310,114480
1.00E+12,200,40500,16.3,248500,40500,1,208000,248500
2.10E+12,310,305,7.5,4080,305,1,3775,4080
2.10E+12,310,2072,35.2,5880,2072,1,3808,5880
2.10E+12,200,880,10,8800,880,1,7920,8800
1.00E+12,511,167,16.7,1000,3000,18,15000,18000
1.00E+12,310,188,9.5,1980,188,1,1792,1980
1.00E+12,310,360,9.5,3780,360,1,3420,3780
2.10E+12,310,113,9.5,1180,225,2,2135,2360
2.10E+12,310,2467,9.6,25800,2467,1,23333,25800
7335759,240,1392,40,3480,2784,2,4176,6960
1.00E+12,310,278,10,2780,1390,5,12510,13900
1.00E+12,310,358,10,3580,358,1,3222,3580
8633267,310,1042,9.5,10980,1042,1,9938,10980
1.00E+12,310,757,9.5,7980,757,1,7223,7980
10529379,310,473,9.5,4980,946,2,9014,9960
1.00E+12,310,275,5,5500,275,1,5225,5500
1.00E+12,200,1787,6.9,25900,1787,1,24113,25900
1.00E+12,205,2370,30,7900,7110,3,16590,23700
7113661,310,74,5,1480,74,1,1406,1480
1.00E+12,310,617,11.6,5300,1234,2,9366,10600
1.00E+12,100,617,11.6,5300,1234,2,9366,10600
1.00E+12,310,350,10,3500,700,2,6300,7000
1.00E+12,511,3795,55,6900,7590,2,6210,13800
1.00E+12,500,24480,19.2,127200,24480,1,102720,127200
2.10E+12,310,90,7,1280,179,2,2381,2560
1.00E+12,310,1049,7,15000,1049,1,13951,15000
1.00E+12,511,2622,53.5,4900,5243,2,4557,9800
2.10E+12,310,51,7,730,153,3,2037,2190
1.00E+12,310,3583,35.8,10000,7166,2,12834,20000
1.00E+12,310,1433,35.8,4000,1433,1,2567,4000
1.00E+12,310,1827,35.8,5100,1827,1,3273,5100
1.00E+12,310,220,10,2200,660,3,5940,6600
1.00E+12,340,908,7,12980,2724,3,36216,38940
1.00E+12,340,166,7,2380,830,5,11070,11900
1.00E+12,500,2000,20,9980,6000,3,23940,29940
1.00E+12,310,222,6.4,3480,222,1,3258,3480
7452337,310,89,6.4,1400,89,1,1311,1400
2.10E+12,200,864,18.8,4590,864,1,3726,4590
1.00E+12,340,498,10,4980,1494,3,13446,14940
6615115,310,681,14.5,4700,681,1,4019,4700
1.00E+12,601,1000,14.5,6900,1000,1,5900,6900
1.00E+12,200,5260,15,35100,5260,1,29840,35100
1.00E+12,200,1150,5,23000,1150,1,21850,23000
1.00E+12,310,686,7,9800,686,1,9114,9800
1.00E+12,310,299,7,4280,4186,14,55734,59920
1.00E+12,310,990,10,9900,1980,2,17820,19800
8983948,601,225,5,4500,225,1,4275,4500
1.00E+12,240,1464,30,4880,4392,3,10248,14640
7095585,310,448,9,4980,448,1,4532,4980
10007742,310,719,9,7980,719,1,7261,7980
1.00E+12,200,945,5,18900,945,1,17955,18900
1.00E+12,310,940,17.5,5380,940,1,4440,5380
1.00E+12,310,1447,17.5,8280,1447,1,6833,8280
9658413,310,286,8.2,3500,572,2,6428,7000
7156320,310,96,8.2,1180,289,3,3251,3540
1.00E+12,310,120,8.1,1480,120,1,1360,1480
1.00E+12,310,612,8.2,7500,612,1,6888,7500
1.00E+12,310,70,7,1000,350,5,4650,5000
1.00E+12,310,84,7,1200,168,2,2232,2400
1.00E+12,240,10160,37.4,27200,50800,5,85200,136000
1.00E+12,200,11214,12.6,89000,11214,1,77786,89000
6610188,601,192,20.4,940,192,1,748,940
1.00E+12,200,23303,19.6,119000,23303,1,95697,119000
1.00E+12,300,24124,16.3,148000,24124,1,123876,148000
1.00E+12,310,138,7,1980,138,1,1842,1980
1.00E+12,340,192,7,2750,384,2,5116,5500
1.00E+12,310,292,7,4180,292,1,3888,4180
8104636,310,166,7,2380,166,1,2214,2380
1.00E+12,310,87,8.7,1000,87,1,913,1000
1.00E+12,310,433,8.7,4980,433,1,4547,4980
1.00E+12,310,564,8.7,6480,564,1,5916,6480
1.00E+12,310,259,8.7,2980,259,1,2721,2980
1.00E+12,200,9500,10,95000,9500,1,85500,95000
1.00E+12,200,550,5.5,10000,550,1,9450,10000
1.00E+12,310,2250,5,45000,2250,1,42750,45000
7580677,601,427,9.7,4380,854,2,7906,8760
7291156,601,466,9.7,4780,466,1,4314,4780
1.00E+12,310,734,5,14680,734,1,13946,14680
1.00E+12,200,6737,19.2,35000,6737,1,28263,35000
8333638,601,72,9.6,750,72,1,678,750
7628565,310,378,10,3780,7182,19,64638,71820
7452337,310,98,7,1400,98,1,1302,1400
1.00E+12,200,1210,10,12100,1210,1,10890,12100
6610267,310,352,11.8,2990,1056,3,7914,8970
2.10E+12,310,698,10,6980,4188,6,37692,41880
2.10E+12,310,2227,25,8900,6681,3,20019,26700
1.00E+12,200,470,2.9,15950,470,1,15480,15950
1.00E+12,310,870,14.5,6000,2610,3,15390,18000
1.00E+12,310,1328,9.5,13980,3984,3,37956,41940
1.00E+12,310,422,11.5,3680,1266,3,9774,11040
2.10E+12,100,113,11.4,990,113,1,877,990
7050044,100,342,11.5,2980,342,1,2638,2980
1.00E+12,100,870,14.5,6000,870,1,5130,6000
2.10E+12,100,687,11.5,5980,687,1,5293,5980
9030701,340,614,3.9,15900,614,1,15286,15900
1.00E+12,501,572,11.5,4980,572,1,4408,4980
8210501,310,1534,9.1,16900,1534,1,15366,16900
1.00E+12,310,1813,18.2,9980,1813,1,8167,9980
1.00E+12,200,5572,28,19900,5572,1,14328,19900
1.00E+12,310,1590,10,15900,1590,1,14310,15900
1.00E+12,310,8396,15.8,53000,8396,1,44604,53000
1.00E+12,200,8395,15.8,53000,8395,1,44605,53000
1.00E+12,200,252,6,4200,252,1,3948,4200
2.10E+12,310,187,7,2680,187,1,2493,2680
2.10E+12,310,236,7,3380,236,1,3144,3380
1.00E+12,310,1118,7,15980,1118,1,14862,15980
1.00E+12,200,1138,38.2,2980,1138,1,1842,2980
2.10E+12,310,149,5,2980,298,2,5662,5960
1.00E+12,310,151,8.5,1780,151,1,1629,1780
6825294,310,138,8.5,1630,138,1,1492,1630
1.00E+12,310,125,8.4,1480,125,1,1355,1480
1.00E+12,310,7599,19.5,39000,7599,1,31401,39000
8941610,240,100,9.3,1080,1500,15,14700,16200
1.00E+12,310,503,18.3,2750,503,1,2247,2750
2.10E+12,310,774,9.2,8380,774,1,7606,8380
7416866,205,1698,32.2,5280,3396,2,7164,10560
1.00E+12,310,188,9.9,1900,188,1,1712,1900
8328491,601,260,5,5200,260,1,4940,5200
2.10E+12,310,290,9.7,2980,580,2,5380,5960
2.10E+12,310,968,27.8,3480,3870,4,10050,13920
1.00E+12,310,172,4.3,3980,172,1,3808,3980
2.10E+12,310,90,4.3,2080,90,1,1990,2080
1.00E+12,310,42,4.3,980,42,1,938,980
8070120,310,966,7,13800,1932,2,25668,27600
1.00E+12,310,1490,10,14900,1490,1,13410,14900
9069313,310,790,10,7900,790,1,7110,7900
1.00E+12,310,690,10,6900,690,1,6210,6900
1.00E+12,310,118,10,1180,4366,37,39294,43660
1.00E+12,310,270,10,2700,270,1,2430,2700
1.00E+12,310,449,5,8980,449,1,8531,8980
1.00E+12,200,2250,10,22500,2250,1,20250,22500
1.00E+12,310,522,19,2750,4698,9,20052,24750
8562095,310,498,10,4980,996,2,8964,9960
1.00E+12,200,1540,3,51500,1540,1,49960,51500
1.00E+12,500,900,5,18000,900,1,17100,18000
6610869,310,420,15.3,2750,839,2,4661,5500
1.00E+12,310,57,5.8,980,57,1,923,980
1.00E+12,200,6920,7.8,89000,6920,1,82080,89000
2.10E+12,340,138,7,1980,138,1,1842,1980
1.00E+12,310,118,10,1180,118,1,1062,1180
1.00E+12,310,798,10,7980,798,1,7182,7980
1.00E+12,200,1200,20,6000,1200,1,4800,6000
1.00E+12,310,1780,4.8,36900,1780,1,35120,36900
6927206,310,389,9.8,3980,778,2,7182,7960
8594928,310,190,9.7,1950,190,1,1760,1950
7095596,310,175,7.3,2390,175,1,2215,2390
1.00E+12,200,6039,14.5,41650,6039,1,35611,41650
1.00E+12,200,4231,15.8,26700,4231,1,22469,26700
1.00E+12,100,1269,11.6,10900,3807,3,28893,32700
1.00E+12,310,5706,11.6,48980,17118,3,129822,146940
7531864,310,538,10,5380,538,1,4842,5380
1.00E+12,240,2230,25,8920,2230,1,6690,8920
1.00E+12,200,4350,15,29000,4350,1,24650,29000
1.00E+12,310,108,4.4,2480,108,1,2372,2480
1.00E+12,310,213,4.4,4880,213,1,4667,4880
1.00E+12,310,200,4.4,4580,200,1,4380,4580
1.00E+12,310,82,4.4,1880,164,2,3596,3760
1.00E+12,310,200,4.4,4580,200,1,4380,4580
9700882,310,174,4.4,3980,174,1,3806,3980
8104634,310,166,7,2380,332,2,4428,4760
2.10E+12,310,1400,28,5000,2800,2,7200,10000
1.00E+12,300,7450,50,14900,14900,2,14900,29800
1.00E+12,310,34,9.8,348,476,14,4396,4872
8548950,310,650,10,6500,650,1,5850,6500
1.00E+12,310,623,7,8900,623,1,8277,8900
1.00E+12,310,18516,13.2,140000,18516,1,121484,140000
1.00E+12,310,642,6.7,9600,642,1,8958,9600
9654373,310,84,5,1680,168,2,3192,3360
1.00E+12,240,262,19,1380,2096,8,8944,11040
1.00E+12,240,817,23.5,3480,3268,4,10652,13920
6617570,310,299,7,4280,598,2,7962,8560
1.00E+12,340,558,7,7980,558,1,7422,7980
1.00E+12,310,623,7,8900,1869,3,24831,26700
1.00E+12,500,14283,28.7,49840,14283,1,35557,49840
7587266,310,45,6.9,650,135,3,1815,1950
1.00E+12,310,208,7,2980,208,1,2772,2980
1.00E+12,310,404,16.3,2480,404,1,2076,2480
1.00E+12,310,404,16.3,2480,1212,3,6228,7440
1.00E+12,240,404,16.3,2480,404,1,2076,2480
1.00E+12,340,117,7,1680,117,1,1563,1680
1.00E+12,200,3780,20,18900,3780,1,15120,18900
1.00E+12,310,464,9.3,5000,1856,4,18144,20000
1.00E+12,310,512,9.3,5500,512,1,4988,5500
1.00E+12,200,14216,22.9,62000,14216,1,47784,62000
1.00E+12,200,3604,18.4,19600,3604,1,15996,19600
1.00E+12,340,588,10,5880,1176,2,10584,11760
1.00E+12,200,446,8,5580,892,2,10268,11160
1.00E+12,200,53200,28,190000,53200,1,136800,190000
1.00E+12,310,1274,25.6,4980,2548,2,7412,9960
1.00E+12,310,137,5,2750,822,6,15678,16500
1.00E+12,310,515,12.9,3980,1546,3,10394,11940
1.00E+12,100,298,10,2980,298,1,2682,2980
6615615,100,280,10,2800,280,1,2520,2800
1.00E+12,310,500,10,5000,500,1,4500,5000
10458872,240,733,16.3,4500,733,1,3767,4500
1.00E+12,205,13650,40.5,33700,27300,2,40100,67400
1.00E+12,310,37,8.5,430,734,20,7866,8600
8931426,310,896,8.5,10500,896,1,9604,10500
9605043,240,4880,40,12200,19520,4,29280,48800
1.00E+12,310,483,7,6900,483,1,6417,6900
7865342,310,399,5,7980,399,1,7581,7980
1.00E+12,310,89,5,1780,356,4,6764,7120
2.10E+12,340,558,7,7980,558,1,7422,7980
7936333,340,488,7,6980,488,1,6492,6980
1.00E+12,310,149,5,2980,149,1,2831,2980
8797815,310,996,10,9980,996,1,8984,9980
1.00E+12,310,397,10,3980,397,1,3583,3980
8929134,310,948,10,9480,2844,3,25596,28440
7445176,310,83,8.4,990,249,3,2721,2970
7130308,310,470,8.4,5600,2817,6,30783,33600
6612788,310,294,7,4200,294,1,3906,4200
8844842,310,299,6.4,4650,299,1,4351,4650
1.00E+12,511,312,37.6,830,8432,27,13978,22410
8095171,300,79,1,7980,79,1,7901,7980
8023190,300,69,1,6960,69,1,6891,6960
1.00E+12,300,42,1,4280,42,1,4238,4280
1.00E+12,300,1546,7.9,19510,1546,1,17964,19510
8333662,310,448,16.3,2750,896,2,4604,5500
1.00E+12,500,0,0,72000,0,1,72000,72000
1.00E+12,300,56853,7.8,726000,56853,1,669147,726000
1.00E+12,100,399,5,7990,399,1,7591,7990
1.00E+12,310,349,5,6980,698,2,13262,13960
1.00E+12,310,1580,20,7900,1580,1,6320,7900
2.10E+12,601,559,11.6,4800,559,1,4241,4800
2.10E+12,601,349,11.6,3000,349,1,2651,3000
1.00E+12,310,540,10,5400,1620,3,14580,16200
1.00E+12,100,84,5,1680,84,1,1596,1680
7419878,100,298,10,2980,298,1,2682,2980
1.00E+12,310,2590,25.9,10000,2590,1,7410,10000
8983477,310,460,10,4600,1380,3,12420,13800
1.00E+12,310,178,10,1780,178,1,1602,1780
1.00E+12,310,349,5,6980,349,1,6631,6980
1.00E+12,300,2490,10,24900,2490,1,22410,24900
10733416,100,504,10,5040,504,1,4536,5040
1.00E+12,205,2553,37,6900,2553,1,4347,6900
1.00E+12,310,599,5,11980,1198,2,22762,23960
1.00E+12,310,550,5,11000,550,1,10450,11000
1.00E+12,310,249,5,4990,498,2,9482,9980
1.00E+12,310,185,10,1850,6660,36,59940,66600
1.00E+12,200,1470,14,10500,5880,4,36120,42000
1.00E+12,240,1474,55,2680,1474,1,1206,2680
1.00E+12,310,160,10,1600,160,1,1440,1600
7695376,310,315,7,4500,630,2,8370,9000
1.00E+12,310,191,8,2380,381,2,4379,4760
2.10E+12,310,79,8,990,79,1,911,990
2.10E+12,310,94,8,1180,94,1,1086,1180
1.00E+12,310,134,8,1680,402,3,4638,5040
1.00E+12,310,447,8,5580,447,1,5133,5580
2.10E+12,310,79,8,980,157,2,1803,1960
1.00E+12,310,320,8.5,3780,640,2,6920,7560
1.00E+12,200,20700,15,138000,20700,1,117300,138000
1.00E+12,310,220,7,3150,660,3,8790,9450
1.00E+12,205,1863,25.6,7280,1863,1,5417,7280
2.10E+12,310,4859,37.4,12980,9717,2,16243,25960
2.10E+12,310,1880,28.5,6600,1880,1,4720,6600
2.10E+12,310,316,10.6,2980,632,2,5328,5960
1.00E+12,100,3825,51,7500,3825,1,3675,7500
2.10E+12,100,1880,28.5,6600,1880,1,4720,6600
6614394,310,1380,10,13800,1380,1,12420,13800
1.00E+12,310,101878,17.2,592000,101878,1,490122,592000
1.00E+12,310,361,9.1,3980,361,1,3619,3980
10354262,310,271,9.1,2980,2168,8,21672,23840
1.00E+12,310,2980,20,14900,2980,1,11920,14900
8049971,310,593,6.7,8800,593,1,8207,8800
1.00E+12,310,962,6.7,14280,962,1,13318,14280
1.00E+12,310,862,6.7,12800,862,1,11938,12800
1.00E+12,310,2753,14.5,18990,5506,2,32474,37980
1.00E+12,205,2753,14.5,18990,5506,2,32474,37980
2.10E+12,310,2481,43.3,5730,2481,1,3249,5730
2.10E+12,200,2515,43.3,5810,2515,1,3295,5810
1.00E+12,200,6570,10,65700,6570,1,59130,65700
1.00E+12,310,1596,7,22800,1596,1,21204,22800
1.00E+12,200,105,3,3500,105,1,3395,3500
1.00E+12,310,171,8.6,1980,171,1,1809,1980
10731995,310,347,11.6,2980,347,1,2633,2980
10698740,100,987,11.6,8480,987,1,7493,8480
1.00E+12,100,1374,11.6,11800,1374,1,10426,11800
7107515,601,114,11.6,980,228,2,1732,1960
8117982,340,306,7,4380,306,1,4074,4380
1.00E+12,310,368,10,3680,736,2,6624,7360
1.00E+12,205,1996,20,9980,3992,2,15968,19960
1.00E+12,310,239,5,4780,239,1,4541,4780
8333547,310,274,5,5480,274,1,5206,5480
2.10E+12,310,152,7,2180,304,2,4056,4360
1.00E+12,310,1980,10,19800,1980,1,17820,19800
9035829,310,99,5,1990,99,1,1891,1990
1.00E+12,310,249,5,4980,249,1,4731,4980
1.00E+12,200,14413,34.9,41300,28826,2,53774,82600
1.00E+12,200,1170,3,39000,1170,1,37830,39000
1.00E+12,200,8930,23.5,38000,8930,1,29070,38000
1.00E+12,310,278,7,3980,556,2,7404,7960
1.00E+12,310,10000,1.1,920000,10000,1,910000,920000
1.00E+12,310,121,9.5,1280,242,2,2318,2560
7460695,310,561,9.5,5930,561,1,5369,5930
2.10E+12,310,198,10,1980,198,1,1782,1980
2.10E+12,205,1920,14.9,12900,1920,1,10980,12900
1.00E+12,200,3900,10,39000,3900,1,35100,39000
2.10E+12,310,368,10,3680,368,1,3312,3680
7718090,310,660,10,6600,660,1,5940,6600
1.00E+12,500,35280,8.8,400000,35280,1,364720,400000
1.00E+12,340,1846,7,26380,1846,1,24534,26380
6611364,310,199,5.9,3400,796,4,12804,13600
1.00E+12,200,5500,10,55000,5500,1,49500,55000
1.00E+12,310,94,5,1880,94,1,1786,1880
1.00E+12,310,822,6.1,13580,822,1,12758,13580
2.10E+12,310,2280,16.5,13800,6840,3,34560,41400
1.00E+12,310,290,10,2900,290,1,2610,2900
8226427,310,656,9.6,6800,656,1,6144,6800
1.00E+12,310,856,9.6,8880,856,1,8024,8880
1.00E+12,511,8720,54.8,15900,17439,2,14361,31800
2.10E+12,310,231,7,3300,231,1,3069,3300
1.00E+12,310,68,6.9,980,68,1,912,980
1.00E+12,200,111900,19.4,578000,223800,2,932200,1156000
1.00E+12,500,111900,19.4,578000,223800,2,932200,1156000
1.00E+12,200,16451,23.7,69300,16451,1,52849,69300
1.00E+12,340,19775,23.7,83300,19775,1,63525,83300
1.00E+12,310,119,5,2380,119,1,2261,2380
1.00E+12,310,669,19.2,3480,1338,2,5622,6960
1.00E+12,200,1188,6,19800,1188,1,18612,19800
1.00E+12,200,11024,20.8,53000,11024,1,41976,53000
1.00E+12,200,21200,13.3,160000,42400,2,277600,320000
7234772,310,528,10,5280,1056,2,9504,10560
1.00E+12,200,11992,19.2,62300,11992,1,50308,62300
1.00E+12,200,6435,9.8,66000,6435,1,59565,66000
1.00E+12,500,2176,8,27200,2176,1,25024,27200
1.00E+12,205,1874,36.7,5100,9370,5,16130,25500
1.00E+12,310,1874,36.7,5100,9370,5,16130,25500
1.00E+12,310,2885,21,13760,2885,1,10875,13760
1.00E+12,200,11320,24,47200,11320,1,35880,47200
1.00E+12,310,1569,32.2,4880,3138,2,6622,9760
2.10E+12,310,763,7,10900,763,1,10137,10900
1.00E+12,310,189,5,3780,378,2,7182,7560
1.00E+12,310,398,14.5,2750,398,1,2352,2750
1.00E+12,240,398,14.5,2750,398,1,2352,2750
1.00E+12,601,97,9.7,1000,97,1,903,1000
1.00E+12,310,868,10,8680,868,1,7812,8680
1.00E+12,310,990,10,9900,990,1,8910,9900
1.00E+12,310,174,5,3480,174,1,3306,3480
1.00E+12,310,74,5,1480,74,1,1406,1480
1.00E+12,340,21,7,300,21,1,279,300
1.00E+12,200,5100,15,34000,5100,1,28900,34000
1.00E+12,310,349,5,6980,349,1,6631,6980
1.00E+12,310,489,5,9780,1956,4,37164,39120
1.00E+12,310,165,5,3300,165,1,3135,3300
1.00E+12,310,84,5,1680,84,1,1596,1680
1.00E+12,310,175,5,3500,175,1,3325,3500
6610015,310,225,9.1,2480,2246,10,22554,24800
2.10E+12,310,535,9.1,5900,2138,4,21462,23600
1.00E+12,340,1043,7,14900,1043,1,13857,14900
6619811,310,628,7,8980,628,1,8352,8980
7890663,310,99,5,1980,594,6,11286,11880
1.00E+12,310,1356,6.8,19900,1356,1,18544,19900
1.00E+12,310,339,6.8,4980,339,1,4641,4980
1.00E+12,310,67,6.8,980,200,3,2740,2940
8491497,310,436,6.8,6400,436,1,5964,6400
1.00E+12,240,2994,30,9980,23952,8,55888,79840
1.00E+12,340,668,7,9550,668,1,8882,9550
7054090,601,651,13.4,4850,651,1,4199,4850
7248547,601,534,13.4,3980,534,1,3446,3980
1.00E+12,310,174,5,3480,174,1,3306,3480
9694677,310,298,10,2980,596,2,5364,5960
1.00E+12,310,498,10,4980,1494,3,13446,14940
1.00E+12,310,990,10,9900,1980,2,17820,19800
10467212,310,625,5,12500,625,1,11875,12500
1.00E+12,200,14320,20,71600,14320,1,57280,71600
8843182,310,219,5,4380,876,4,16644,17520
1.00E+12,310,201,8.8,2280,603,3,6237,6840
1.00E+12,310,256,8.8,2900,768,3,7932,8700
1.00E+12,310,263,8.8,2980,789,3,8151,8940
1.00E+12,100,256,8.8,2900,256,1,2644,2900
26604,200,3300,15,22000,3300,1,18700,22000
1.00E+12,300,4890,16.3,30000,4890,1,25110,30000
2.10E+12,310,3087,26.1,11850,3087,1,8763,11850
8941521,310,598,10,5980,598,1,5382,5980
2.10E+12,310,1380,10,13800,1380,1,12420,13800
1.00E+12,310,21396,19.6,109000,21396,1,87604,109000
1.00E+12,200,5970,15,39800,5970,1,33830,39800
1.00E+12,200,2590,2.2,116900,2590,1,114310,116900
1.00E+12,310,594,5,11880,594,1,11286,11880
6610205,310,68,6.9,980,816,12,10944,11760
1.00E+12,310,1300,16.3,7980,1300,1,6680,7980
1.00E+12,310,550,10,5500,1100,2,9900,11000
8983477,310,501,10.9,4600,501,1,4099,4600
9707919,310,107,10.8,990,107,1,883,990
1.00E+12,310,760,10.9,6980,760,1,6220,6980
8983477,501,501,10.9,4600,501,1,4099,4600
1.00E+12,501,498,10.9,4580,498,1,4082,4580
1.00E+12,501,945,10.9,8680,945,1,7735,8680
1.00E+12,501,433,10.9,3980,433,1,3547,3980
1.00E+12,340,558,7,7980,558,1,7422,7980
1.00E+12,340,663,7,9480,663,1,8817,9480
2.10E+12,310,1644,24,6850,1644,1,5206,6850
1.00E+12,310,1828,9.1,19980,1828,1,18152,19980
1.00E+12,310,364,9.1,3980,364,1,3616,3980
1.00E+12,310,2377,9.1,25980,2377,1,23603,25980
1.00E+12,205,22500,30,75000,22500,1,52500,75000
1.00E+12,310,544,9.1,5980,1631,3,16309,17940
2.10E+12,200,1744,19.4,8980,1744,1,7236,8980
1.00E+12,200,32400,24,135000,32400,1,102600,135000
8846974,310,95,7.9,1200,189,2,2211,2400
1.00E+12,310,392,7.9,4980,392,1,4588,4980
2.10E+12,200,7037,35.5,19800,14074,2,25526,39600
1.00E+12,310,956,9.6,9980,956,1,9024,9980
2.10E+12,200,1044,30,3480,6264,6,14616,20880
6609550,310,137,14.4,950,685,5,4065,4750
1.00E+12,310,907,4.3,20900,907,1,19993,20900
1.00E+12,310,488,7,6980,488,1,6492,6980
1.00E+12,310,474,5,9480,474,1,9006,9480
1.00E+12,200,11060,14,79000,33180,3,203820,237000
1.00E+12,200,5960,10,59600,5960,1,53640,59600
1.00E+12,200,2490,10,24900,2490,1,22410,24900
1.00E+12,200,20860,20,104300,20860,1,83440,104300
1.00E+12,200,9400,8.3,113500,9400,1,104100,113500
1.00E+12,200,7900,10,79000,7900,1,71100,79000
1.00E+12,200,11850,15,79000,11850,1,67150,79000
1.00E+12,310,595,10,5950,595,1,5355,5950
1.00E+12,310,398,10,3980,398,1,3582,3980
1.00E+12,310,290,10,2900,580,2,5220,5800
1.00E+12,310,9408,24,39200,9408,1,29792,39200
1.00E+12,310,378,10,3780,378,1,3402,3780
2.10E+12,310,478,10,4780,478,1,4302,4780
1.00E+12,310,598,10,5980,598,1,5382,5980
6844939,310,898,10,8980,1796,2,16164,17960
1.00E+12,310,99,10,990,99,1,891,990
2.10E+12,310,3160,35.2,8980,6320,2,11640,17960
1.00E+12,200,3986,8.8,45500,3986,1,41514,45500
1.00E+12,100,1185,4.9,24000,1185,1,22815,24000
1.00E+12,310,459,7.9,5800,459,1,5341,5800
1.00E+12,310,839,7.9,10600,839,1,9761,10600
1.00E+12,310,780,9.8,7980,780,1,7200,7980
9077258,511,1471,54.9,2680,2942,2,2418,5360
1.00E+12,200,1780,20,8900,3560,2,14240,17800
1.00E+12,200,2490,5,49800,2490,1,47310,49800
1.00E+12,200,21120,16,132000,21120,1,110880,132000
1.00E+12,200,5390,7,77000,5390,1,71610,77000
2.10E+12,310,387,5.2,7480,774,2,14186,14960
6618834,310,361,5.2,6980,361,1,6619,6980
8117928,310,257,5.2,4980,257,1,4723,4980
1.00E+12,200,1194,6,19900,1194,1,18706,19900
1.00E+12,200,1620,6,27000,1620,1,25380,27000
6861945,310,725,10,7250,725,1,6525,7250
1.00E+12,310,100,10,1000,1700,17,15300,17000
1.00E+12,310,3903,13.2,29500,3903,1,25597,29500
1.00E+12,310,3280,8.4,39000,3280,1,35720,39000
8333662,310,192,7,2750,384,2,5116,5500
1.00E+12,310,891,9.7,9200,1781,2,16619,18400
1.00E+12,310,43,9.6,449,1730,40,16230,17960
6616347,310,672,9.6,6980,672,1,6308,6980
7134845,310,373,9.6,3880,373,1,3507,3880
1.00E+12,100,6203,14.1,44000,6203,1,37797,44000
7103426,340,558,7,7980,558,1,7422,7980
1.00E+12,501,24,1,2480,24,1,2456,2480
1.00E+12,200,8965,16.3,55000,8965,1,46035,55000
1.00E+12,100,171,10.8,1580,342,2,2818,3160
7050044,100,324,10.9,2980,1944,6,15936,17880
2.10E+12,200,1000,10.2,9800,2000,2,17600,19600
1.00E+12,501,79,1,7980,79,1,7901,7980
1.00E+12,310,1626,8.6,18880,1626,1,17254,18880
1.00E+12,310,401,8.6,4680,401,1,4279,4680
1.00E+12,310,218,10,2180,436,2,3924,4360
2.10E+12,310,790,10,7900,1580,2,14220,15800
8692222,310,191,5,3830,955,5,18195,19150
1.00E+12,310,680,9.7,6980,3400,5,31500,34900
1.00E+12,310,249,5,4980,1494,6,28386,29880
1.00E+12,601,349,9.7,3580,349,1,3231,3580
1.00E+12,310,490,10,4900,490,1,4410,4900
2.10E+12,310,855,16.3,5250,3420,4,17580,21000
1.00E+12,310,6741,53.5,12600,26964,4,23436,50400
1.00E+12,310,306,16.3,1880,918,3,4722,5640
1.00E+12,200,12040,18.2,66300,12040,1,54260,66300
1.00E+12,200,4770,5,95400,4770,1,90630,95400
1.00E+12,240,2668,18.7,14300,2668,1,11632,14300
1.00E+12,310,320,7,4580,320,1,4260,4580
1.00E+12,310,61,6.9,880,305,5,4095,4400
1.00E+12,310,64,5,1280,128,2,2432,2560
2.10E+12,310,274,5,5480,274,1,5206,5480
7151302,310,74,5,1480,74,1,1406,1480
1.00E+12,310,534,8.9,5980,534,1,5446,5980
6617837,310,898,10,8980,898,1,8082,8980
2.10E+12,310,595,7.5,7980,1190,2,14770,15960
2.10E+12,310,1336,7.5,17900,2672,2,33128,35800
1.00E+12,200,1494,6,24900,1494,1,23406,24900
2.10E+12,310,68,10,680,204,3,1836,2040
1.00E+12,310,1290,10,12900,2580,2,23220,25800
2.10E+12,310,420,10,4200,840,2,7560,8400
1.00E+12,310,118,10,1180,590,5,5310,5900
1.00E+12,310,1060,10,10600,1060,1,9540,10600
7594661,310,499,5,9980,499,1,9481,9980
8110997,310,1168,10,11680,2336,2,21024,23360
7624856,310,640,10,6400,640,1,5760,6400
1.00E+12,310,3917,20.6,19000,3917,1,15083,19000
1.00E+12,200,4310,21.8,19800,4310,1,15490,19800
1.00E+12,100,2783,15.5,17980,2783,1,15197,17980
10533151,310,349,10,3490,698,2,6282,6980
7409756,310,528,10,5280,8448,16,76032,84480
1.00E+12,310,89,5,1780,178,2,3382,3560
1.00E+12,310,119,5,2380,119,1,2261,2380
1.00E+12,200,1290,14.3,9000,1290,1,7710,9000
1.00E+12,200,4000,10,40000,4000,1,36000,40000
1.00E+12,310,8719,21.1,41300,8719,1,32581,41300
1.00E+12,310,516,2.6,19800,516,1,19284,19800
7530673,310,230,10,2300,920,4,8280,9200
1.00E+12,240,190,10,1900,1900,10,17100,19000
1.00E+12,310,698,10,6980,2094,3,18846,20940
1.00E+12,310,243,7,3480,486,2,6474,6960
1.00E+12,200,51876,15.7,330000,51876,1,278124,330000
1.00E+12,200,2080,15,13900,2080,1,11820,13900
1.00E+12,310,768,7,10980,1536,2,20424,21960
1.00E+12,310,0,0,1900,0,2,3800,3800
1.00E+12,310,0,0,4980,0,2,9960,9960
1.00E+12,310,259,6,4300,259,1,4041,4300
6616378,310,390,6,6480,390,1,6090,6480
7291156,310,288,6,4780,288,1,4492,4780
1.00E+12,310,360,6,5980,360,1,5620,5980
7501565,310,541,6,8980,541,1,8439,8980
7252138,310,106,6,1750,633,6,9867,10500
1.00E+12,100,4450,28,15900,4450,1,11450,15900
2.10E+12,501,277,11.8,2350,277,1,2073,2350
1.00E+12,310,118,5,2370,236,2,4504,4740
1.00E+12,310,99,5,1980,99,1,1881,1980
1.00E+12,310,164,5,3280,164,1,3116,3280
1.00E+12,100,737,19,3880,737,1,3143,3880
1.00E+12,100,362,14.5,2500,362,1,2138,2500
1.00E+12,100,813,19,4280,813,1,3467,4280
1.00E+12,310,298,10,2980,1788,6,16092,17880
8069282,310,232,9.3,2500,464,2,4536,5000
2.10E+12,310,279,9.3,3000,557,2,5443,6000
2.10E+12,310,883,9.3,9500,883,1,8617,9500
1.00E+12,200,890,7,12800,890,1,11910,12800
1.00E+12,200,1610,7,23100,1610,1,21490,23100
1.00E+12,340,1398,7,19980,4194,3,55746,59940
1.00E+12,310,299,5,5980,897,3,17043,17940
1.00E+12,310,922,5,18450,922,1,17528,18450
1.00E+12,100,4770,14.5,32900,4770,1,28130,32900
2.10E+12,310,13953,34.9,39980,27906,2,52054,79960
1.00E+12,310,59,5,1180,59,1,1121,1180
1.00E+12,200,5237,20.9,25000,5237,1,19763,25000
1.00E+12,500,5824,20.9,27800,5824,1,21976,27800
1.00E+12,240,552,19.9,2780,2208,4,8912,11120
2.10E+12,310,134,5,2680,134,1,2546,2680
8634003,310,117,5,2350,351,3,6699,7050
1.00E+12,310,0,0,2480,0,2,4960,4960
2.10E+12,310,0,0,2080,0,2,4160,4160
1.00E+12,200,1552,15.5,10000,1552,1,8448,10000
1.00E+12,200,3600,12,30000,3600,1,26400,30000
1.00E+12,310,1045,5,20900,1045,1,19855,20900
1.00E+12,300,12040,14.4,83400,12040,1,71360,83400
1.00E+12,310,273,7,3900,273,1,3627,3900
1.00E+12,200,1248,3,41600,1248,1,40352,41600
1.00E+12,310,449,5,8980,898,2,17062,17960
1.00E+12,310,166,7,2380,166,1,2214,2380
6609737,310,188,9,2080,188,1,1892,2080
1.00E+12,310,2930,10,29300,2930,1,26370,29300
2.10E+12,205,2372,43.3,5480,4744,2,6216,10960
1.00E+12,310,407,9.3,4380,407,1,3973,4380
1.00E+12,200,5230,15,34900,5230,1,29670,34900
8703173,310,395,5,7900,395,1,7505,7900
1.00E+12,310,369,5,7380,369,1,7011,7380
1.00E+12,310,84,5,1680,84,1,1596,1680
1.00E+12,310,49,5,980,147,3,2793,2940
8987339,310,107,5,2150,107,1,2043,2150
1.00E+12,310,174,5,3480,174,1,3306,3480
1.00E+12,601,1229,14.5,8480,1229,1,7251,8480
1.00E+12,310,275,9.2,3000,275,1,2725,3000
1.00E+12,310,5439,18.3,29800,5439,1,24361,29800
1.00E+12,310,364,9.1,3980,364,1,3616,3980
2.10E+12,200,5910,39.7,14900,17731,3,26969,44700
2.10E+12,200,2488,27.7,8980,2488,1,6492,8980
1.00E+12,310,749,5,14980,749,1,14231,14980
2.10E+12,601,1463,29.4,4980,1463,1,3517,4980
2.10E+12,310,1825,29.3,6225,1825,1,4400,6225
1.00E+12,310,99,5,1980,495,5,9405,9900
1.00E+12,310,404,16.3,2480,1616,4,8304,9920
6617166,100,39,2,1980,39,1,1941,1980
2.10E+12,501,336,2,16800,336,1,16464,16800
7630824,310,171,8.6,1980,342,2,3618,3960
6609553,601,137,14.4,950,137,1,813,950
2.10E+12,310,348,10,3480,348,1,3132,3480
2.10E+12,310,2649,40.1,6600,5298,2,7902,13200
6615924,100,508,10,5080,508,1,4572,5080
1.00E+12,100,198,10,1980,792,4,7128,7920
1.00E+12,240,3580,10,35800,14320,4,128880,143200
1.00E+12,310,199,5,3980,199,1,3781,3980
6615110,310,149,5,2980,447,3,8493,8940
2.10E+12,310,419,5,8380,419,1,7961,8380
1.00E+12,310,200,14.5,1380,600,3,3540,4140
1.00E+12,310,99,5,1980,99,1,1881,1980
8431447,310,207,9.5,2180,207,1,1973,2180
1.00E+12,310,843,9.5,8880,843,1,8037,8880
1.00E+12,310,473,9.5,4980,473,1,4507,4980
6609426,310,349,9.5,3680,349,1,3331,3680
6844939,310,449,5,8980,449,1,8531,8980
1.00E+12,310,349,5,6980,349,1,6631,6980
1.00E+12,310,199,5,3980,199,1,3781,3980
1.00E+12,310,214,5,4280,214,1,4066,4280
2.10E+12,310,1333,33.5,3980,3999,3,7941,11940
1.00E+12,200,2371,7.9,29900,2371,1,27529,29900
1.00E+12,500,600,10,6000,600,1,5400,6000
2.10E+12,310,1267,7.1,17900,1267,1,16633,17900
2.10E+12,310,422,7.1,5980,422,1,5558,5980
1.00E+12,340,172,7.9,2180,172,1,2008,2180
6615615,340,222,7.9,2800,222,1,2578,2800
6609543,501,180,7.9,2280,180,1,2100,2280
1.00E+12,300,59910,23.1,259000,59910,1,199090,259000
1.00E+12,200,5850,15,39000,11700,2,66300,78000
1.00E+12,200,36240,20.9,173000,36240,1,136760,173000
1.00E+12,200,3905,5,78100,3905,1,74195,78100
1.00E+12,200,167990,7.9,2140000,167990,1,1972010,2140000
1.00E+12,501,3978,8.9,44900,3978,1,40922,44900
1.00E+12,100,12939,47.6,27200,12939,1,14261,27200
1.00E+12,310,109,5,2180,218,2,4142,4360
1.00E+12,310,1118,7,15980,2236,2,29724,31960
8226427,310,680,10,6800,680,1,6120,6800
1.00E+12,200,11670,30,38900,11670,1,27230,38900
1.00E+12,340,103,5.8,1780,103,1,1677,1780
1.00E+12,340,459,5.8,7900,459,1,7441,7900
8311676,310,118,10,1180,118,1,1062,1180
1.00E+12,310,158,10,1580,158,1,1422,1580
1.00E+12,310,498,10,4980,498,1,4482,4980
1.00E+12,100,98,2,4900,98,1,4802,4900
1.00E+12,310,67,6.8,980,67,1,913,980
8264972,300,1069,21.6,4950,2138,2,7762,9900
1.00E+12,310,298,10,2980,298,1,2682,2980
1.00E+12,200,1751,8.8,19900,1751,1,18149,19900
1.00E+12,240,4450,50,8900,8900,2,8900,17800
1.00E+12,310,763,7,10900,763,1,10137,10900
1.00E+12,310,194,7,2780,194,1,2586,2780
1.00E+12,310,383,6.4,5980,383,1,5597,5980
1.00E+12,310,447,6.4,6980,447,1,6533,6980
1.00E+12,310,580,7.3,7900,580,1,7320,7900
1.00E+12,310,351,6.4,5480,351,1,5129,5480
1.00E+12,100,59,7.3,800,117,2,1483,1600
1.00E+12,100,218,7.3,2980,218,1,2762,2980
1.00E+12,100,1478,16.6,8900,1478,1,7422,8900
1.00E+12,501,1478,16.6,8900,1478,1,7422,8900
1.00E+12,310,513,9.7,5280,513,1,4767,5280
2.10E+12,310,855,9.7,8800,855,1,7945,8800
1.00E+12,310,435,9.7,4480,435,1,4045,4480
1.00E+12,310,445,9.7,4580,890,2,8270,9160
1.00E+12,200,1184,5.9,19900,4736,4,74864,79600
1.00E+12,200,7920,15,52800,7920,1,44880,52800
2.10E+12,310,1690,10,16900,3380,2,30420,33800
1.00E+12,310,193,10.8,1780,193,1,1587,1780
1.00E+12,310,106,10.8,980,106,1,874,980
1.00E+12,100,1504,10.9,13800,1504,1,12296,13800
1.00E+12,501,316,10.9,2900,316,1,2584,2900
1.00E+12,501,258,10.8,2380,258,1,2122,2380
1.00E+12,310,1565,8.7,17980,1565,1,16415,17980
1.00E+12,310,494,8.7,5680,988,2,10372,11360
1.00E+12,310,148,10,1480,148,1,1332,1480
1.00E+12,310,184,5,3680,184,1,3496,3680
1.00E+12,310,44,5,880,44,1,836,880
1.00E+12,310,5408,13,41500,16225,3,108275,124500
1.00E+12,100,415,11.6,3580,829,2,6331,7160
1.00E+12,100,524,16,3280,524,1,2756,3280
1.00E+12,200,749,12.7,5900,3745,5,25755,29500
1.00E+12,310,328,10,3280,984,3,8856,9840
1.00E+12,601,533,14.5,3680,533,1,3147,3680
8462694,310,200,14.5,1380,200,1,1180,1380
2.10E+12,310,1824,19.2,9480,3648,2,15312,18960
7718090,310,348,7,4980,696,2,9264,9960
2.10E+12,310,383,7,5480,1149,3,15291,16440
7022435,310,469,7,6700,469,1,6231,6700
1.00E+12,310,288,10,2880,576,2,5184,5760
9024595,310,189,5,3780,189,1,3591,3780
1.00E+12,310,129,5,2580,129,1,2451,2580
1.00E+12,310,781,9.2,8480,781,1,7699,8480
1.00E+12,310,828,9.2,8980,1655,2,16305,17960
7073945,310,1776,45.5,3900,3551,2,4249,7800
1.00E+12,205,3443,35.2,9780,3443,1,6337,9780
7936136,310,414,5.9,6980,414,1,6566,6980
1.00E+12,310,128,6.4,1980,255,2,3705,3960
1.00E+12,310,768,25.6,3000,1536,2,4464,6000
6890809,310,383,7,5480,1149,3,15291,16440
8023235,310,68,6.9,980,68,1,912,980
2.10E+12,310,383,7,5480,383,1,5097,5480
1.00E+12,200,5542,16.3,34000,5542,1,28458,34000
10370465,340,469,7,6700,469,1,6231,6700
1.00E+12,340,5113,25.7,19900,5113,1,14787,19900
7858995,310,1098,10,10980,2196,2,19764,21960
1.00E+12,310,498,16.7,2980,996,2,4964,5960
1.00E+12,310,1248,10,12480,2496,2,22464,24960
1.00E+12,100,282,10.1,2800,282,1,2518,2800
1.00E+12,310,458,10,4580,458,1,4122,4580
1.00E+12,310,32,9.9,320,1262,40,11538,12800
8095171,100,930,11.7,7980,930,1,7050,7980
2.10E+12,310,1752,9.3,18900,1752,1,17148,18900
1.00E+12,310,1206,10.1,11900,1206,1,10694,11900
2.10E+12,200,2463,35.3,6980,4925,2,9035,13960
1.00E+12,100,342,10.1,3380,342,1,3038,3380
8225929,501,707,10.1,6980,707,1,6273,6980
1.00E+12,501,909,10.1,8980,909,1,8071,8980
8350710,501,241,10.1,2390,724,3,6446,7170
6615474,501,259,10.1,2560,259,1,2301,2560
2.10E+12,501,2369,31.7,7475,2369,1,5106,7475
1.00E+12,310,316,14.5,2180,948,3,5592,6540
8240865,310,235,10,2350,470,2,4230,4700
1.00E+12,200,977,12.7,7700,977,1,6723,7700
1.00E+12,310,741,19,3900,741,1,3159,3900
1.00E+12,310,281,19,1480,281,1,1199,1480
6615244,100,261,14.5,1800,522,2,3078,3600
1.00E+12,100,262,19,1380,262,1,1118,1380
1.00E+12,310,379,5,7580,379,1,7201,7580
1.00E+12,310,588,14.8,3980,1765,3,10175,11940
1.00E+12,310,572,4.8,11900,572,1,11328,11900
1.00E+12,310,191,4.8,3980,191,1,3789,3980
1.00E+12,310,191,4.8,3980,191,1,3789,3980
8131902,310,797,4.8,16580,797,1,15783,16580
1.00E+12,310,330,4.8,6880,330,1,6550,6880
1.00E+12,310,128,4.8,2680,128,1,2552,2680
1.00E+12,205,400,14.9,2680,400,1,2280,2680
1.00E+12,310,5220,14.5,36000,5220,1,30780,36000
1.00E+12,200,2500,10,25000,2500,1,22500,25000
1.00E+12,200,2280,10,22890,6840,3,61830,68670
1.00E+12,200,1890,5,37800,1890,1,35910,37800
8119682,100,186,19,980,372,2,1588,1960
2.10E+12,310,2180,31.6,6900,2180,1,4720,6900
7248547,310,756,19,3980,756,1,3224,3980
2.10E+12,200,4816,23.2,20800,4816,1,15984,20800
1.00E+12,240,2994,30,9980,14970,5,34930,49900
1.00E+12,300,3180,20,15900,3180,1,12720,15900
1.00E+12,200,4760,10,47600,4760,1,42840,47600
8989814,310,382,8.2,4680,1145,3,12895,14040
9669780,310,480,8.2,5880,2878,6,32402,35280
1.00E+12,200,8820,18,49000,44100,5,200900,245000
1.00E+12,310,214,14.5,1480,428,2,2532,2960
1.00E+12,310,145,5,2900,145,1,2755,2900
1.00E+12,310,950,5,19000,1900,2,36100,38000
1.00E+12,310,159,7,2280,9540,60,127260,136800
1.00E+12,310,6264,20.9,29900,18792,3,70908,89700
7248512,310,191,9.6,1980,191,1,1789,1980
1.00E+12,310,384,9.6,3980,384,1,3596,3980
1.00E+12,340,455,7,6500,455,1,6045,6500
1.00E+12,310,944,10,9440,944,1,8496,9440
1.00E+12,310,1498,10,14980,1498,1,13482,14980
1.00E+12,310,390,10,3900,390,1,3510,3900
2.10E+12,310,508,10,5080,508,1,4572,5080
2.10E+12,310,210,5,4200,210,1,3990,4200
1.00E+12,310,545,5,10900,545,1,10355,10900
1.00E+12,310,399,5,7980,399,1,7581,7980
2.10E+12,310,189,5,3790,189,1,3601,3790
1.00E+12,310,398,10,3980,398,1,3582,3980
1.00E+12,310,566,19,2980,566,1,2414,2980
1.00E+12,310,756,19,3980,756,1,3224,3980
1.00E+12,100,4770,14.5,32900,9540,2,56260,65800
2.10E+12,310,1399,23.8,5880,2798,2,8962,11760
1.00E+12,200,1990,10,19900,3980,2,35820,39800
2.10E+12,205,1760,29.9,5880,3520,2,8240,11760
1.00E+12,240,2808,9.8,28800,8424,3,77976,86400
1.00E+12,310,1501,19,7900,1501,1,6399,7900
7332368,310,384,10,3840,1536,4,13824,15360
1.00E+12,200,29640,12,247000,29640,1,217360,247000
1.00E+12,310,350,10,3500,700,2,6300,7000
1.00E+12,310,1948,10,19480,1948,1,17532,19480
10620219,310,2001,14.5,13800,2001,1,11799,13800
1.00E+12,200,3080,16.3,18900,3080,1,15820,18900
9658169,310,786,8.8,8900,786,1,8114,8900
1.00E+12,310,174,8.8,1980,174,1,1806,1980
6611126,310,351,8.8,3980,351,1,3629,3980
2.10E+12,310,828,10,8280,3312,4,29808,33120
1.00E+12,310,208,7,2980,832,4,11088,11920
2.10E+12,310,1982,36.2,5480,1982,1,3498,5480
2.10E+12,310,528,8.8,5980,528,1,5452,5980
2.10E+12,310,342,8.8,3880,342,1,3538,3880
8058810,100,628,10,6280,628,1,5652,6280
7315612,310,361,7.2,4980,361,1,4619,4980
1.00E+12,310,288,7.2,3980,288,1,3692,3980
2.10E+12,310,645,7.2,8900,645,1,8255,8900
6822284,310,259,7.2,3580,259,1,3321,3580
2.10E+12,310,143,7.2,1980,143,1,1837,1980
2.10E+12,200,2394,24,9975,4788,2,15162,19950
1.00E+12,310,13282,19.2,69000,13282,1,55718,69000
1.00E+12,200,431,10.8,4000,431,1,3569,4000
7017300,310,348,7,4980,1044,3,13896,14940
1.00E+12,310,376,7,5380,1128,3,15012,16140
1.00E+12,310,780,14.5,5380,780,1,4600,5380
1.00E+12,200,400,4,10000,400,1,9600,10000
1.00E+12,200,480,4,12000,480,1,11520,12000
1.00E+12,200,5900,10,59000,5900,1,53100,59000
1.00E+12,200,2850,15,19000,2850,1,16150,19000
1.00E+12,200,13200,12,110000,13200,1,96800,110000
1.00E+12,200,12000,20,60000,12000,1,48000,60000
2.10E+12,310,798,10,7980,798,1,7182,7980
6610147,310,598,18.2,3280,2392,4,10728,13120
1.00E+12,310,238,10,2380,1428,6,12852,14280
1.00E+12,310,584,11.8,4950,584,1,4366,4950
1.00E+12,100,351,11.8,2980,351,1,2629,2980
1.00E+12,100,268,11.8,2280,268,1,2012,2280
1.00E+12,100,141,11.8,1200,141,1,1059,1200
1.00E+12,100,256,11.7,2180,256,1,1924,2180
1.00E+12,100,492,11.8,4180,492,1,3688,4180
1.00E+12,501,141,11.8,1200,141,1,1059,1200
1.00E+12,240,928,19.4,4780,1856,2,7704,9560
1.00E+12,205,2371,24,9880,4742,2,15018,19760
2.10E+12,310,590,9.1,6480,1180,2,11780,12960
2.10E+12,310,545,9.1,5980,1090,2,10870,11960
2.10E+12,310,2402,27.3,8800,9606,4,25594,35200
1.00E+12,200,3450,15,23000,3450,1,19550,23000
1.00E+12,310,376,7,5380,376,1,5004,5380
1.00E+12,310,52255,27.3,191200,52255,1,138945,191200
1.00E+12,310,642,9.2,6980,1284,2,12676,13960
2.10E+12,310,357,9.2,3880,2142,6,21138,23280
1.00E+12,200,6500,10,65000,6500,1,58500,65000
8986888,310,174,5,3480,348,2,6612,6960
8056611,310,320,10,3200,640,2,5760,6400
8023099,310,8018,35.8,22400,16036,2,28764,44800
1.00E+12,200,2700,15,18000,2700,1,15300,18000
1.00E+12,501,134,1,13400,134,1,13266,13400
7632909,240,485,16.3,2980,970,2,4990,5960
1.00E+12,200,6815,14.5,47000,6815,1,40185,47000
1.00E+12,300,6815,14.5,47000,6815,1,40185,47000
8914341,511,3795,55,6900,7590,2,6210,13800
1.00E+12,500,1300,5,26000,1300,1,24700,26000
1.00E+12,310,62,5,1240,62,1,1178,1240
1.00E+12,310,268,10,2680,268,1,2412,2680
8401228,310,346,10.8,3190,346,1,2844,3190
1.00E+12,310,247,10.8,2280,247,1,2033,2280
2.10E+12,310,3402,28.7,11850,3402,1,8448,11850
2.10E+12,310,912,10.9,8380,912,1,7468,8380
2.10E+12,100,3402,28.7,11850,3402,1,8448,11850
2.10E+12,200,3402,28.7,11850,3402,1,8448,11850
36629,200,2650,5,53000,2650,1,50350,53000
1.00E+12,200,3730,16.7,22400,3730,1,18670,22400
1.00E+12,310,691,7,9880,1382,2,18378,19760
7408194,310,377,9.5,3980,753,2,7207,7960
9588871,310,329,9.5,3480,329,1,3151,3480
1.00E+12,310,144,5,2880,144,1,2736,2880
1.00E+12,310,1598,10,15980,1598,1,14382,15980
1.00E+12,310,898,10,8980,898,1,8082,8980
1.00E+12,200,578,10,5780,578,1,5202,5780
1.00E+12,500,205,14.4,1420,205,1,1215,1420
1.00E+12,310,1153,6.9,16800,1153,1,15647,16800
1.00E+12,310,198,10,1980,198,1,1782,1980
1.00E+12,310,298,10,2980,1192,4,10728,11920
1.00E+12,310,1470,14,10500,4410,3,27090,31500
1.00E+12,310,600,7,8580,1200,2,15960,17160
1.00E+12,310,463,11.6,3980,463,1,3517,3980
1.00E+12,310,243,7,3480,243,1,3237,3480
1.00E+12,240,536,18,2980,536,1,2444,2980
8333662,310,244,8.9,2750,244,1,2506,2750
8333610,310,373,8.9,4200,373,1,3827,4200
1.00E+12,310,443,8.9,4980,443,1,4537,4980
6609752,310,671,9,7480,1341,2,13619,14960
1.00E+12,310,87,8.9,980,87,1,893,980
9603186,310,69,8.8,780,138,2,1422,1560
1.00E+12,310,443,8.9,4980,443,1,4537,4980
1.00E+12,300,2446,18.8,13000,2446,1,10554,13000
1.00E+12,200,6600,16.3,40500,6600,1,33900,40500
1.00E+12,300,6600,16.3,40500,6600,1,33900,40500
1.00E+12,500,4040,20.4,19800,4040,1,15760,19800
1.00E+12,300,4040,20.4,19800,4040,1,15760,19800
1.00E+12,310,440,5,8800,440,1,8360,8800
1.00E+12,100,16965,17.1,99000,16965,1,82035,99000
1.00E+12,501,8034,25.8,31200,8034,1,23166,31200
1.00E+12,200,1592,8,19900,1592,1,18308,19900
1.00E+12,340,31035,16.3,190400,31035,1,159365,190400
1.00E+12,310,298,10,2980,894,3,8046,8940
1.00E+12,310,258,10,2580,516,2,4644,5160
2.10E+12,205,1933,35.3,5480,1933,1,3547,5480
1.00E+12,200,93520,17.9,522000,93520,1,428480,522000
7858995,340,768,7,10980,768,1,10212,10980
2.10E+12,340,1593,25.6,6225,3186,2,9264,12450
1.00E+12,310,1780,20,8900,1780,1,7120,8900
1.00E+12,310,4980,20,24900,4980,1,19920,24900
1.00E+12,200,82160,18.2,451000,82160,1,368840,451000
1.00E+12,200,3900,10,39000,3900,1,35100,39000
1.00E+12,310,71,5.1,1380,71,1,1309,1380
7150833,310,283,5.2,5480,283,1,5197,5480
7186745,310,918,5.3,17480,918,1,16562,17480
1.00E+12,205,534,30,1780,534,1,1246,1780
8525211,310,858,10,8580,858,1,7722,8580
7038566,310,438,10,4380,438,1,3942,4380
1.00E+12,340,1995,7,28500,1995,1,26505,28500
1.00E+12,200,1409,9.8,14400,1409,1,12991,14400
1.00E+12,310,699,5,13980,699,1,13281,13980
1.00E+12,310,809,9.1,8900,809,1,8091,8900
8218669,310,1089,9.1,11980,1089,1,10891,11980
1.00E+12,100,7,1,700,21,3,2079,2100
1.00E+12,100,47,1,4780,47,1,4733,4780
7452330,501,38,1,3880,38,1,3842,3880
1.00E+12,501,7,1,700,21,3,2079,2100
1.00E+12,200,130,4.7,2750,130,1,2620,2750
1.00E+12,200,2870,9,31900,2870,1,29030,31900
1.00E+12,310,3021,19,15900,12084,4,51516,63600
1.00E+12,240,851,19,4480,3404,4,14516,17920
1.00E+12,310,108,10,1080,108,1,972,1080
8882973,310,848,10,8480,2544,3,22896,25440
1.00E+12,310,15500,22.1,70000,15500,1,54500,70000
1.00E+12,200,15500,22.1,70000,15500,1,54500,70000
1.00E+12,310,8435,53,15900,16869,2,14931,31800
6613798,310,416,6,6900,416,1,6484,6900
2.10E+12,310,107,5.4,1980,107,1,1873,1980
2.10E+12,310,151,5.4,2780,301,2,5259,5560
1.00E+12,310,1253,7,17900,2506,2,33294,35800
2.10E+12,310,224,6.4,3480,224,1,3256,3480
1.00E+12,310,77,6.4,1200,77,1,1123,1200
1.00E+12,500,7474,20.2,37000,29896,4,118104,148000
1.00E+12,100,99,5,1980,99,1,1881,1980
1.00E+12,310,1045,5,20900,2090,2,39710,41800
1.00E+12,300,12360,20.9,59000,12360,1,46640,59000
1.00E+12,200,3040,16,19000,3040,1,15960,19000
1.00E+12,200,4620,5,92500,4620,1,87880,92500
1.00E+12,310,508,15.5,3280,2540,5,13860,16400
6824754,310,214,5,4280,214,1,4066,4280
1.00E+12,310,1015,7,14500,1015,1,13485,14500
1.00E+12,310,117,7,1680,117,1,1563,1680
1.00E+12,601,333,14.5,2300,333,1,1967,2300
1.00E+12,601,333,14.5,2300,333,1,1967,2300
1.00E+12,310,333,14.5,2300,333,1,1967,2300
1.00E+12,340,112,7,1600,112,1,1488,1600
1.00E+12,340,35,7,500,350,10,4650,5000
1.00E+12,501,2544,9.7,26100,5088,2,47112,52200
1.00E+12,310,360,10,3600,360,1,3240,3600
2.10E+12,205,2396,20,11980,2396,1,9584,11980
1.00E+12,340,62,7,890,434,7,5796,6230
1.00E+12,200,1790,10,17900,1790,1,16110,17900
1.00E+12,310,2730,12.7,21500,2730,1,18770,21500
1.00E+12,310,770,7,11000,770,1,10230,11000
1.00E+12,310,105,7,1500,315,3,4185,4500
1.00E+12,310,7081,23.6,30000,14162,2,45838,60000
1.00E+12,310,117,5.9,1980,234,2,3726,3960
8549264,310,212,5.9,3580,212,1,3368,3580
2.10E+12,501,2933,24.8,11850,5866,2,17834,23700
7350960,310,578,11.8,4900,578,1,4322,4900
1.00E+12,501,342,11.8,2900,342,1,2558,2900
7350960,501,578,11.8,4900,578,1,4322,4900
10456592,501,4278,30.8,13900,4278,1,9622,13900
1.00E+12,501,8888,55.9,15900,17776,2,14024,31800
1.00E+12,300,10816,20.8,52000,10816,1,41184,52000
1.00E+12,200,9725,25,38900,19450,2,58350,77800
1.00E+12,310,1826,5.4,34100,9130,5,161370,170500
1.00E+12,200,790,5,15800,790,1,15010,15800
1.00E+12,310,548,10,5480,1644,3,14796,16440
1.00E+12,310,538,10,5380,1614,3,14526,16140
1.00E+12,310,184,5,3680,184,1,3496,3680
1.00E+12,310,488,7,6980,488,1,6492,6980
7904387,310,137,6.9,1980,137,1,1843,1980
8069844,310,3063,24.5,12500,3063,1,9437,12500
1.00E+12,240,3165,19.9,15900,3165,1,12735,15900
8069844,240,3063,24.5,12500,3063,1,9437,12500
8069844,100,3063,24.5,12500,3063,1,9437,12500
1.00E+12,501,1173,19.9,5900,1173,1,4727,5900
1.00E+12,501,269,6.9,3880,269,1,3611,3880
1.00E+12,501,200,6.9,2880,200,1,2680,2880
1.00E+12,501,348,7,5000,348,1,4652,5000
1.00E+12,300,53010,12.7,418000,53010,1,364990,418000
2.10E+12,310,2598,32.6,7980,2598,1,5382,7980
1.00E+12,310,652,16.3,4000,1304,2,6696,8000
7891324,200,1613,16.3,9900,8065,5,41435,49500
1.00E+12,310,1748,20.6,8480,3496,2,13464,16960
1.00E+12,310,84,5,1690,672,8,12848,13520
1.00E+12,310,198,10,1980,198,1,1782,1980
7624187,310,171,19,900,171,1,729,900
1.00E+12,100,950,19,5000,950,1,4050,5000
1.00E+12,240,496,20,2480,1488,3,5952,7440
1.00E+12,511,1633,33.3,4900,4900,3,9800,14700
1.00E+12,500,1600,9.4,17000,1600,1,15400,17000
1.00E+12,200,14700,10,147000,14700,1,132300,147000
8023347,310,1458,10,14580,1458,1,13122,14580
7248512,310,198,10,1980,396,2,3564,3960
1.00E+12,500,5600,22.4,25000,22400,4,77600,100000
8306133,100,19,1,1980,19,1,1961,1980
8228240,340,2370,53.5,4430,9480,4,8240,17720
1.00E+12,200,4050,15,27000,8100,2,45900,54000
1.00E+12,500,4952,11.8,42000,4952,1,37048,42000
1.00E+12,240,2728,17.2,15900,2728,1,13172,15900
1.00E+12,200,36630,20.5,179100,36630,1,142470,179100
1.00E+12,100,17,4.9,348,34,2,662,696
6609254,340,350,7,5000,350,1,4650,5000
1.00E+12,310,1580,20,7900,1580,1,6320,7900
1.00E+12,200,9936,8,124200,9936,1,114264,124200
1.00E+12,200,1930,3.5,54800,1930,1,52870,54800
8564084,310,298,10,2980,298,1,2682,2980
2.10E+12,310,15902,37,42980,31804,2,54156,85960
1.00E+12,200,15040,10,150400,15040,1,135360,150400
1.00E+12,200,2900,5,58000,2900,1,55100,58000
1.00E+12,310,288,14.5,1990,864,3,5106,5970
1.00E+12,511,2390,50,4780,9560,4,9560,19120
1.00E+12,500,1296,2,64800,1296,1,63504,64800
1.00E+12,500,26851,17.5,153000,26851,1,126149,153000
1.00E+12,500,7683,22.4,34300,7683,1,26617,34300
7392951,340,98,4.9,1980,98,1,1882,1980
1.00E+12,310,973,7,13900,973,1,12927,13900
1.00E+12,310,1950,5,39000,1950,1,37050,39000
10354260,310,298,10,2980,894,3,8046,8940
7054085,310,249,6.3,3980,249,1,3731,3980
1.00E+12,310,890,6.4,13980,890,1,13090,13980
1.00E+12,310,598,10,5980,1196,2,10764,11960
1.00E+12,310,98,10,980,2548,26,22932,25480
1.00E+12,310,5800,14.5,40000,5800,1,34200,40000
1.00E+12,310,946,19,4980,4730,5,20170,24900
1.00E+12,310,1198,10,11980,1198,1,10782,11980
1.00E+12,310,590,5,11800,590,1,11210,11800
1.00E+12,310,2345,5,46900,4690,2,89110,93800
1.00E+12,240,245,12.4,1980,245,1,1735,1980
1.00E+12,200,2235,15,14900,2235,1,12665,14900
7922852,310,247,5.9,4180,247,1,3933,4180
10733446,100,271,5.9,4580,271,1,4309,4580
2.10E+12,310,895,10,8980,1789,2,16171,17960
1.00E+12,310,356,9.9,3580,356,1,3224,3580
1.00E+12,310,178,9,1980,178,1,1802,1980
1.00E+12,310,269,9,2980,537,2,5423,5960
1.00E+12,310,563,9,6250,563,1,5687,6250
10007079,310,161,9,1780,963,6,9717,10680
1.00E+12,200,645,5,12900,645,1,12255,12900
1.00E+12,240,409,10.8,3780,2451,6,20229,22680
1.00E+12,340,2555,14.9,17100,2555,1,14545,17100
9659200,310,736,14.5,5080,736,1,4344,5080
9658413,310,665,19,3500,665,1,2835,3500
1.00E+12,100,1302,14.5,8980,1302,1,7678,8980
9658413,100,665,19,3500,665,1,2835,3500
1.00E+12,240,248,10,2480,248,1,2232,2480
1.00E+12,511,2938,38.7,7600,8815,3,13985,22800
1.00E+12,310,398,8,4980,1194,3,13746,14940
1.00E+12,310,206,8,2580,206,1,2374,2580
1.00E+12,310,1197,8,14980,1197,1,13783,14980
1.00E+12,310,224,12.6,1780,224,1,1556,1780
7150833,310,690,12.6,5480,690,1,4790,5480
1.00E+12,100,8483,25,34000,8483,1,25517,34000
2.10E+12,310,1842,17.1,10800,3683,2,17917,21600
1.00E+12,310,424,5,8480,424,1,8056,8480
8300666,310,199,5,3980,398,2,7562,7960
7149484,310,545,5,10900,545,1,10355,10900
1.00E+12,240,1835,33.5,5480,3670,2,7290,10960
1.00E+12,310,1606,38.2,4200,1606,1,2594,4200
1.00E+12,310,1172,33.5,3500,10548,9,20952,31500
1.00E+12,310,1172,33.5,3500,10548,9,20952,31500
1.00E+12,310,966,9.7,9980,966,1,9014,9980
1.00E+12,310,869,9.7,8980,869,1,8111,8980
2.10E+12,310,285,9.9,2880,285,1,2595,2880
2.10E+12,310,262,9.8,2680,262,1,2418,2680
1.00E+12,300,280,1,28000,840,3,83160,84000
7021910,240,95,8.8,1080,667,7,6893,7560
1.00E+12,300,5359,11.7,46000,5359,1,40641,46000
7938700,310,7745,53.5,14480,15489,2,13471,28960
1.00E+12,310,415,7,5950,829,2,11071,11900
2.10E+12,310,414,5,8280,828,2,15732,16560
10223492,100,1084,14.5,7480,1084,1,6396,7480
1.00E+12,500,32,4.9,650,960,30,18540,19500
2.10E+12,310,1727,16.3,10600,3454,2,17746,21200
2.10E+12,310,880,10,8800,1760,2,15840,17600
1.00E+12,310,890,5,17800,890,1,16910,17800
1.00E+12,310,477,9.7,4900,1908,4,17692,19600
7901414,310,192,9.7,1980,384,2,3576,3960
8983935,310,436,9.7,4500,436,1,4064,4500
1.00E+12,310,500,8.4,5980,500,1,5480,5980
2.10E+12,310,903,8.4,10800,903,1,9897,10800
1.00E+12,200,3600,24,15000,7200,2,22800,30000
1.00E+12,200,3000,20,15000,3000,1,12000,15000
1.00E+12,340,250,7,3580,250,1,3330,3580
1.00E+12,200,690,5,13800,690,1,13110,13800
9599107,310,789,12.6,6280,3156,4,21964,25120
2.10E+12,310,859,24,3580,1718,2,5442,7160
2.10E+12,310,436,11,3980,436,1,3544,3980
2.10E+12,310,293,10.9,2680,293,1,2387,2680
6609563,310,260,10.9,2380,260,1,2120,2380
2.10E+12,310,655,11,5980,655,1,5325,5980
1.00E+12,310,1094,11,9980,1094,1,8886,9980
2.10E+12,310,205,10.9,1880,205,1,1675,1880
6609563,100,260,10.9,2380,260,1,2120,2380
2.10E+12,100,1294,11,11800,1294,1,10506,11800
1.00E+12,100,249,10.9,2280,249,1,2031,2280
2.10E+12,100,1576,28.8,5480,1576,1,3904,5480
2.10E+12,100,293,10.9,2680,293,1,2387,2680
2.10E+12,100,633,11,5780,633,1,5147,5780
1.00E+12,200,1194,6,19900,1194,1,18706,19900
7252138,340,122,7,1750,854,7,11396,12250
1.00E+12,200,2997,10.9,27500,2997,1,24503,27500
1.00E+12,310,866,8.7,9980,866,1,9114,9980
1.00E+12,310,498,10,4980,498,1,4482,4980
6609737,100,123,5.9,2080,246,2,3914,4160
1.00E+12,100,542,10.9,4980,542,1,4438,4980
1.00E+12,501,269,10.8,2480,1614,6,13266,14880
1.00E+12,501,337,10.9,3100,337,1,2763,3100
1.00E+12,340,14592,25.6,57000,14592,1,42408,57000
1.00E+12,100,45,1,4580,90,2,9070,9160
1.00E+12,100,62,1,6280,124,2,12436,12560
1.00E+12,501,62,1,6280,124,2,12436,12560
8068394,501,9,0.9,980,36,4,3884,3920
1.00E+12,310,216,6,3580,216,1,3364,3580
1.00E+12,310,446,6,7380,446,1,6934,7380
9669773,310,521,6.1,8600,1562,3,24238,25800
8082162,601,375,5,7500,375,1,7125,7500
1.00E+12,310,108,10,1080,108,1,972,1080
1.00E+12,310,150,10,1500,150,1,1350,1500
3533045,200,15300,10,153000,15300,1,137700,153000
6609236,100,168,10,1680,168,1,1512,1680
1.00E+12,300,139,1,13990,139,1,13851,13990
1.00E+12,310,898,10,8980,898,1,8082,8980
2.10E+12,340,488,7,6980,488,1,6492,6980
1.00E+12,340,588,7,8400,588,1,7812,8400
1.00E+12,200,7410,19,39000,7410,1,31590,39000
1.00E+12,310,200,5,4000,200,1,3800,4000
1.00E+12,310,980,8.2,11900,980,1,10920,11900
1.00E+12,310,608,8.1,7480,608,1,6872,7480
1.00E+12,310,304,7.8,3900,304,1,3596,3900
1.00E+12,310,155,7.8,1980,309,2,3651,3960
1.00E+12,310,256,7.8,3280,256,1,3024,3280
1.00E+12,310,93,7.8,1200,93,1,1107,1200
1.00E+12,310,1150,10,11500,1150,1,10350,11500
8634617,310,138,7.3,1880,138,1,1742,1880
8986773,310,131,7.4,1780,131,1,1649,1780
1.00E+12,310,1215,7.4,16480,1215,1,15265,16480
1.00E+12,310,957,7.4,12980,957,1,12023,12980
1.00E+12,300,6656,20.8,32000,6656,1,25344,32000
6615155,601,193,9.7,1980,193,1,1787,1980
7891089,310,193,9.7,1980,193,1,1787,1980
1.00E+12,310,798,10,7980,1596,2,14364,15960
1.00E+12,310,1298,10,12980,1298,1,11682,12980
1.00E+12,310,5944,18,33000,5944,1,27056,33000
1.00E+12,310,990,10,9900,990,1,8910,9900
10007879,310,1398,10,13980,1398,1,12582,13980
1.00E+12,310,1198,10,11980,2396,2,21564,23960
1.00E+12,310,648,10,6480,648,1,5832,6480
1.00E+12,310,6283,15.8,39700,6283,1,33417,39700
2.10E+12,100,61,2,3080,61,1,3019,3080
2.10E+12,100,39,2,1980,39,1,1941,1980
1.00E+12,310,265,9.5,2800,265,1,2535,2800
1.00E+12,310,990,10,9900,990,1,8910,9900
1.00E+12,310,1098,22.9,4800,1098,1,3702,4800
1.00E+12,100,855,14.5,5900,855,1,5045,5900
1.00E+12,200,855,14.5,5900,855,1,5045,5900
1.00E+12,501,225,5,4500,225,1,4275,4500
1.00E+12,501,225,5,4500,225,1,4275,4500
1.00E+12,200,2280,10,22800,2280,1,20520,22800
1.00E+12,511,3450,50,6900,6900,2,6900,13800
1.00E+12,310,8170,19,43000,8170,1,34830,43000
1.00E+12,200,500,5,10000,500,1,9500,10000
9596153,310,945,5,18900,945,1,17955,18900
1.00E+12,200,5250,15,35000,10500,2,59500,70000
1.00E+12,340,2000,16.7,11980,2000,1,9980,11980
1.00E+12,240,567,16.3,3480,567,1,2913,3480
1.00E+12,340,469,16.3,2880,469,1,2411,2880
1.00E+12,310,5473,29.7,18400,10946,2,25854,36800
2.10E+12,310,590,11.8,5000,1770,3,13230,15000
1.00E+12,310,10601,21.2,49900,10601,1,39299,49900
1.00E+12,200,7179,12,59900,7179,1,52721,59900
1.00E+12,310,586,7.3,7980,586,1,7394,7980
1.00E+12,310,1178,10,11780,1178,1,10602,11780
7533704,310,162,5,3250,162,1,3088,3250
1.00E+12,310,349,5,6980,349,1,6631,6980
1.00E+12,310,40,5.5,730,242,6,4138,4380
1.00E+12,310,775,5.5,13980,775,1,13205,13980
6835828,310,260,5.5,4700,260,1,4440,4700
1.00E+12,310,109,5.5,1980,109,1,1871,1980
6610187,310,40,5.5,730,161,4,2759,2920
6610954,240,1470,30,4900,4410,3,10290,14700
6616457,310,1692,22,7680,1692,1,5988,7680
2.10E+12,310,494,8.3,5980,494,1,5486,5980
1.00E+12,310,521,8.3,6300,521,1,5779,6300
1.00E+12,310,97,8.2,1180,97,1,1083,1180
1.00E+12,310,81,8.3,980,81,1,899,980
7151323,310,89,8.2,1080,89,1,991,1080
8526874,310,350,7,5000,350,1,4650,5000
8352523,501,75,2,3780,75,1,3705,3780
7074037,310,393,8.6,4580,393,1,4187,4580
1.00E+12,310,196,8.6,2280,1174,6,12506,13680
1.00E+12,310,281,8.6,3280,281,1,2999,3280
1.00E+12,310,600,8.6,6990,600,1,6390,6990
7698440,310,364,7,5200,364,1,4836,5200
1.00E+12,300,6520,16.3,40000,6520,1,33480,40000
1.00E+12,310,393,9.9,3980,393,1,3587,3980
1.00E+12,200,3280,10,32800,3280,1,29520,32800
7083255,310,139,7.9,1750,139,1,1611,1750
1.00E+12,310,879,12.6,6980,879,1,6101,6980
1.00E+12,310,252,9,2780,1006,4,10114,11120
1.00E+12,310,179,9,1980,179,1,1801,1980
1.00E+12,310,4522,9.6,46900,4522,1,42378,46900
1.00E+12,500,3920,16,24500,3920,1,20580,24500
1.00E+12,200,9310,20.9,44500,9310,1,35190,44500
1.00E+12,100,3357,16.1,20900,3357,1,17543,20900
1.00E+12,601,287,14.5,1980,287,1,1693,1980
1.00E+12,310,287,14.5,1980,287,1,1693,1980
1.00E+12,310,792,40,1980,2376,3,3564,5940
2.10E+12,200,2205,31.6,6980,6615,3,14325,20940
8333645,310,82,10,820,82,1,738,820
1.00E+12,500,461476,17.2,2683000,461476,1,2221524,2683000
2.10E+12,310,261,10.9,2400,261,1,2139,2400
1.00E+12,310,2598,10,25980,2598,1,23382,25980
2.10E+12,100,261,10.9,2400,261,1,2139,2400
1.00E+12,310,7000,20,35000,7000,1,28000,35000
2.10E+12,310,1990,18.3,10900,3980,2,17820,21800
2.10E+12,200,1990,18.3,10900,3980,2,17820,21800
,,,,,,,,
1.00E+12,240,1516,19,7980,3032,2,12928,15960
9030704,310,1930,10,19300,1930,1,17370,19300
1.00E+12,200,6450,5,129000,6450,1,122550,129000
1.00E+12,200,700,8.9,7900,700,1,7200,7900
1.00E+12,310,1090,10,10900,1090,1,9810,10900
1.00E+12,200,5400,17.3,31200,5400,1,25800,31200
1.00E+12,310,10000,6.9,145000,10000,1,135000,145000
1.00E+12,100,5698,37,15400,17094,3,29106,46200
7570707,310,1395,5,27900,1395,1,26505,27900
1.00E+12,500,8393,19.3,43600,8393,1,35207,43600
1.00E+12,310,744,9.3,7980,744,1,7236,7980
1.00E+12,310,371,9.3,3980,371,1,3609,3980
1.00E+12,310,651,9.3,6980,651,1,6329,6980
1.00E+12,310,1304,9.3,13980,1304,1,12676,13980
1.00E+12,310,238,10,2380,238,1,2142,2380
1.00E+12,200,2640,10,26460,2640,1,23820,26460
1.00E+12,200,1100,5,22000,1100,1,20900,22000
1.00E+12,310,129,8.7,1480,129,1,1351,1480
1.00E+12,310,549,7.9,6980,549,1,6431,6980
1.00E+12,100,334,8.8,3800,334,1,3466,3800
1.00E+12,100,86,8.7,990,172,2,1808,1980
8231610,100,788,8.8,8980,788,1,8192,8980
1.00E+12,100,1004,25.7,3900,1004,1,2896,3900
1.00E+12,100,305,8.8,3480,305,1,3175,3480
1.00E+12,100,700,8.8,7980,700,1,7280,7980
8231610,501,788,8.8,8980,788,1,8192,8980
1.00E+12,501,1004,25.7,3900,1004,1,2896,3900
1.00E+12,501,219,8.8,2480,1315,6,13565,14880
1.00E+12,100,1870,14.5,12900,1870,1,11030,12900
1.00E+12,200,1870,14.5,12900,1870,1,11030,12900
1.00E+12,340,119,6,1980,238,2,3722,3960
1.00E+12,200,1590,10,15900,1590,1,14310,15900
2.10E+12,310,1013,7,14480,1013,1,13467,14480
1.00E+12,200,3960,12,33000,3960,1,29040,33000
10626914,310,1738,9.7,17980,1738,1,16242,17980
7622922,310,222,6.8,3280,222,1,3058,3280
1.00E+12,310,202,6.8,2980,202,1,2778,2980
1.00E+12,310,406,6.8,5980,406,1,5574,5980
1.00E+12,310,67,6.8,980,798,12,10962,11760
7049672,310,313,7,4480,626,2,8334,8960
1.00E+12,310,3162,16.3,19400,6324,2,32476,38800
8498199,310,1323,7,18900,1323,1,17577,18900
8226080,601,274,5,5490,274,1,5216,5490
1.00E+12,601,4566,46.1,9900,4566,1,5334,9900
1.00E+12,601,8719,46.1,18900,8719,1,10181,18900
1.00E+12,310,8257,46.1,17900,8257,1,9643,17900
1.00E+12,310,8719,46.1,18900,8719,1,10181,18900
1.00E+12,205,8719,46.1,18900,8719,1,10181,18900
1.00E+12,205,11948,46.1,25900,11948,1,13952,25900
2.10E+12,200,1168,30.9,3780,2336,2,5224,7560
1.00E+12,310,478,10,4780,478,1,4302,4780
1.00E+12,200,745,5,14900,745,1,14155,14900
2.10E+12,310,124,7,1780,124,1,1656,1780
1.00E+12,200,11750,23.5,50000,11750,1,38250,50000
1.00E+12,200,6219,12.7,49000,6219,1,42781,49000
8131902,310,1658,10,16580,1658,1,14922,16580
1.00E+12,200,1248,18.1,6900,1248,1,5652,6900
1.00E+12,310,792,40,1980,2376,3,3564,5940
10223829,310,452,9.1,4950,452,1,4498,4950
7694606,310,265,9.1,2900,265,1,2635,2900
1.00E+12,310,90,9.1,980,1074,12,10686,11760
10009099,100,814,10.9,7480,814,1,6666,7480
1.00E+12,501,106,10.8,980,106,1,874,980
1.00E+12,501,498,10.9,4580,498,1,4082,4580
1.00E+12,501,869,10.9,7980,869,1,7111,7980
1.00E+12,100,828,10,8280,828,1,7452,8280
1.00E+12,200,3000,10,30000,3000,1,27000,30000
1.00E+12,310,351,8.8,3980,351,1,3629,3980
2.10E+12,310,908,7,12980,908,1,12072,12980
6609420,310,339,9.5,3580,339,1,3241,3580
1.00E+12,310,1712,9.6,17900,1712,1,16188,17900
6615244,310,170,9.4,1800,170,1,1630,1800
1.00E+12,310,298,10,2980,596,2,5364,5960
1.00E+12,200,6489,20.8,31200,6489,1,24711,31200
1.00E+12,310,299,7,4280,299,1,3981,4280
8560590,310,110,7,1580,110,1,1470,1580
8117977,310,194,7,2780,194,1,2586,2780
8553755,310,600,10,6000,600,1,5400,6000
1.00E+12,100,8490,19.3,43900,25470,3,106230,131700
1.00E+12,200,6240,20,31200,6240,1,24960,31200
2.10E+12,200,2180,17,12800,2180,1,10620,12800
1.00E+12,310,68,6.9,980,136,2,1824,1960
1.00E+12,310,973,7,13900,973,1,12927,13900
1.00E+12,310,1405,7.8,17980,1405,1,16575,17980
1.00E+12,310,545,7.8,6980,545,1,6435,6980
1.00E+12,310,5990,25.1,23900,11980,2,35820,47800
2.10E+12,310,1954,37,5280,1954,1,3326,5280
1.00E+12,200,9746,8.9,110000,9746,1,100254,110000
1.00E+12,200,625,5,12500,625,1,11875,12500
1.00E+12,310,1584,55,2880,15840,10,12960,28800
1.00E+12,205,6945,34.9,19900,6945,1,12955,19900
7642194,100,99,10,990,198,2,1782,1980
1.00E+12,100,132,10,1320,132,1,1188,1320
1.00E+12,310,1677,8.7,19280,1677,1,17603,19280
1.00E+12,340,4585,6.6,69600,4585,1,65015,69600
1.00E+12,500,4585,6.6,69600,4585,1,65015,69600
1.00E+12,310,990,10,9900,990,1,8910,9900
8120832,310,98,10,980,98,1,882,980
1.00E+12,501,149,10.8,1380,149,1,1231,1380
2.10E+12,340,1586,22.7,6980,1586,1,5394,6980
2.10E+12,310,159,7,2280,159,1,2121,2280
2.10E+12,310,8341,34.9,23900,8341,1,15559,23900
2.10E+12,310,558,7,7980,558,1,7422,7980
1.00E+12,601,49,5,980,49,1,931,980
2.10E+12,310,986,14.5,6800,986,1,5814,6800
1.00E+12,310,504,14.5,3480,504,1,2976,3480
7150833,310,638,11.6,5480,1914,3,14526,16440
1.00E+12,310,69,7,990,69,1,921,990
1.00E+12,310,283,9.5,2980,565,2,5395,5960
8333620,310,346,9.5,3650,692,2,6608,7300
8333658,310,365,9.5,3850,365,1,3485,3850
8917703,310,567,9.5,5980,567,1,5413,5980
1.00E+12,310,283,9.5,2980,565,2,5395,5960
1.00E+12,310,6462,23.5,27500,6462,1,21038,27500
1.00E+12,310,5510,19,29000,5510,1,23490,29000
1.00E+12,310,6345,23.5,27000,6345,1,20655,27000
1.00E+12,200,6345,23.5,27000,6345,1,20655,27000
1.00E+12,200,990,10,9900,990,1,8910,9900
8225929,310,565,8.1,6980,565,1,6415,6980
1.00E+12,310,3560,35.7,9980,7119,2,12841,19960
1.00E+12,310,1064,9.9,10800,1064,1,9736,10800
2.10E+12,310,869,9.9,8800,1737,2,15863,17600
1.00E+12,310,573,19.2,2980,573,1,2407,2980
1.00E+12,200,6700,18.6,36000,6700,1,29300,36000
2.10E+12,310,138,7,1980,138,1,1842,1980
1.00E+12,310,310,5.2,5980,310,1,5670,5980
6615115,310,243,5.2,4700,243,1,4457,4700
8328977,310,74,7.5,980,147,2,1813,1960
1.00E+12,200,1571,24.2,6500,1571,1,4929,6500
1.00E+12,310,375,7.5,4980,375,1,4605,4980
7588534,310,75,7.5,1000,75,1,925,1000
1.00E+12,310,319,38.4,830,8606,27,13804,22410
1.00E+12,310,3289,24.2,13600,3289,1,10311,13600
1.00E+12,310,82,6.9,1180,82,1,1098,1180
1.00E+12,300,13617,20.9,65000,13617,1,51383,65000
1.00E+12,310,49,5,980,98,2,1862,1960
8069883,205,947,25.6,3700,947,1,2753,3700
1.00E+12,310,6090,14.5,42000,6090,1,35910,42000
10367842,310,320,9.3,3450,320,1,3130,3450
2.10E+12,310,462,9.3,4980,462,1,4518,4980
2.10E+12,310,880,9.3,9480,880,1,8600,9480
7104925,240,2058,36.8,5590,2058,1,3532,5590
7104925,310,2058,36.8,5590,2058,1,3532,5590
2.10E+12,200,3781,19,19900,3781,1,16119,19900
1.00E+12,310,418,8.7,4800,418,1,4382,4800
6916804,310,609,8.7,6980,1826,3,19114,20940
2.10E+12,310,739,8.7,8480,739,1,7741,8480
1.00E+12,310,558,9.5,5900,558,1,5342,5900
1.00E+12,310,614,9.4,6500,614,1,5886,6500
2.10E+12,310,986,21.5,4590,1972,2,7208,9180
2.10E+12,200,367,16.7,2200,367,1,1833,2200
1.00E+12,300,16650,11.6,143000,16650,1,126350,143000
1.00E+12,200,10260,20.9,49000,10260,1,38740,49000
2.10E+12,310,653,10,6530,653,1,5877,6530
1.00E+12,310,178,10,1780,178,1,1602,1780
6942752,340,483,7,6900,483,1,6417,6900
1.00E+12,200,11690,16.7,70000,11690,1,58310,70000
9704383,310,2081,9.1,22980,2081,1,20899,22980
1.00E+12,310,994,9.1,10980,1988,2,19972,21960
1.00E+12,310,435,13.6,3200,4350,10,27650,32000
1.00E+12,310,16450,23.5,70000,16450,1,53550,70000
1.00E+12,310,1249,34.9,3580,2498,2,4662,7160
1.00E+12,310,698,10,6980,698,1,6282,6980
1.00E+12,310,1625,9.8,16600,1625,1,14975,16600
1.00E+12,310,1134,13.5,8400,1134,1,7266,8400
1.00E+12,340,9611,24.9,38600,9611,1,28989,38600
1.00E+12,200,2995,5,59900,2995,1,56905,59900
9750424,310,706,8.8,7980,706,1,7274,7980
1.00E+12,310,116,8.8,1320,232,2,2408,2640
8583223,310,422,8.8,4780,422,1,4358,4780
8987339,100,190,8.8,2150,190,1,1960,2150
6609408,100,352,8.8,3980,704,2,7256,7960
2.10E+12,100,699,8.8,7900,699,1,7201,7900
7445509,501,219,8.8,2490,219,1,2271,2490
1.00E+12,501,325,8.8,3680,325,1,3355,3680
8023223,501,248,8.9,2800,248,1,2552,2800
1.00E+12,501,116,8.8,1320,232,2,2408,2640
2.10E+12,501,88,8.8,1000,176,2,1824,2000
7216724,501,352,8.8,3980,352,1,3628,3980
1.00E+12,501,263,8.8,2980,263,1,2717,2980
7299217,501,965,8.9,10900,965,1,9935,10900
1.00E+12,501,1196,8.9,13500,1196,1,12304,13500
1.00E+12,200,7000,20,35000,7000,1,28000,35000
10732157,310,529,8.8,5980,529,1,5451,5980
8594928,100,172,8.8,1950,172,1,1778,1950
1.00E+12,100,263,8.8,2980,263,1,2717,2980
1.00E+12,200,2116,13.4,15780,2116,1,13664,15780
,,,,,,,,
1.00E+12,200,690,5,13900,1380,2,26420,27800
1.00E+12,310,793,13.3,5980,793,1,5187,5980
1.00E+12,100,793,13.3,5980,793,1,5187,5980
1.00E+12,100,979,13.3,7380,2936,3,19204,22140
2.10E+12,310,4436,24.9,17800,4436,1,13364,17800
1.00E+12,310,523,7,7480,523,1,6957,7480
1.00E+12,310,593,7,8480,1186,2,15774,16960
1.00E+12,310,250,7,3580,750,3,9990,10740
6609526,310,131,9.5,1380,131,1,1249,1380
1.00E+12,205,2314,27.6,8380,2314,1,6066,8380
2.10E+12,100,94,1,9480,94,1,9386,9480
1.00E+12,501,0,0,980,0,30,29400,29400
1.00E+12,100,416,5,8330,832,2,15828,16660
1.00E+12,100,138,7.8,1780,552,4,6568,7120
2.10E+12,100,931,7.8,11960,931,1,11029,11960
1.00E+12,501,138,7.8,1780,552,4,6568,7120
1.00E+12,200,160,8,2000,480,3,5520,6000
1.00E+12,200,1800,15,12000,1800,1,10200,12000
1.00E+12,300,7216,15.4,47000,7216,1,39784,47000
7574496,310,446,7,6380,446,1,5934,6380
1.00E+12,310,1750,5,35000,1750,1,33250,35000
1.00E+12,200,5568,24,23200,5568,1,17632,23200
1.00E+12,200,6133,21.1,29000,6133,1,22867,29000
9669773,310,860,10,8600,7740,9,69660,77400
1.00E+12,200,3180,8.9,35900,3180,1,32720,35900
1.00E+12,310,1080,10,10800,1080,1,9720,10800
,,,,,,,,
2.10E+12,310,100,8.4,1180,299,3,3241,3540
1.00E+12,310,640,5,12800,640,1,12160,12800
1.00E+12,200,3600,10,36000,3600,1,32400,36000
1.00E+12,200,1920,5,38400,1920,1,36480,38400
1.00E+12,340,194,7,2780,194,1,2586,2780
1.00E+12,310,44,5.5,800,132,3,2268,2400
1.00E+12,310,385,5.5,6980,385,1,6595,6980
1.00E+12,310,772,5.5,13980,772,1,13208,13980
2.10E+12,310,54,5.5,990,54,1,936,990
2.10E+12,310,652,5.5,11800,652,1,11148,11800
9656160,310,248,10,2480,248,1,2232,2480
1.00E+12,310,225,5,4500,225,1,4275,4500
8094400,240,498,10,4980,1992,4,17928,19920
10732911,340,44,4.5,980,44,1,936,980
9584368,340,179,4.5,3980,179,1,3801,3980
8562095,340,224,4.5,4980,224,1,4756,4980
2.10E+12,340,966,7,13800,966,1,12834,13800
1.00E+12,300,31731,35.8,88650,31731,1,56919,88650
6615534,310,306,9.3,3280,306,1,2974,3280
1.00E+12,310,1983,9.4,21200,3966,2,38434,42400
1.00E+12,310,90,9,990,179,2,1801,1980
1.00E+12,310,1175,9.2,12800,1175,1,11625,12800
1.00E+12,310,227,9.1,2500,227,1,2273,2500
1.00E+12,310,316,9.1,3480,316,1,3164,3480
1.00E+12,200,13800,10,138000,13800,1,124200,138000
1.00E+12,200,940,8,11800,940,1,10860,11800
1.00E+12,200,4640,14.5,32000,9280,2,54720,64000
1.00E+12,310,1218,8.9,13700,7306,6,74894,82200
1.00E+12,310,1495,5,29900,1495,1,28405,29900
1.00E+12,310,127,6.4,1980,382,3,5558,5940
1.00E+12,310,1614,9.5,16980,1614,1,15366,16980
8627914,310,523,7,7480,523,1,6957,7480
1.00E+12,310,798,10,7980,798,1,7182,7980
1.00E+12,310,299,5,5980,299,1,5681,5980
1.00E+12,310,991,8.3,11980,1982,2,21978,23960
1.00E+12,310,11310,14.5,78000,11310,1,66690,78000
2.10E+12,240,1480,10,14800,2960,2,26640,29600
1.00E+12,200,1012,7.8,12900,2024,2,23776,25800
1.00E+12,310,711,6.6,10800,711,1,10089,10800
1.00E+12,310,4523,25.3,17900,4523,1,13377,17900
1.00E+12,205,650,10,6500,650,1,5850,6500
1.00E+12,200,7020,18,39000,7020,1,31980,39000
1.00E+12,240,1096,20,5480,1096,1,4384,5480
1.00E+12,200,16450,23.5,70000,16450,1,53550,70000
1.00E+12,310,758,10,7580,758,1,6822,7580
1.00E+12,310,737,10.6,6980,1474,2,12486,13960
1.00E+12,310,843,10.6,7980,1686,2,14274,15960
1.00E+12,310,410,10.6,3880,820,2,6940,7760
2.10E+12,310,272,10.5,2580,544,2,4616,5160
2.10E+12,310,3628,36.4,9980,10884,3,19056,29940
2.10E+12,200,3628,36.4,9980,10884,3,19056,29940
1.00E+12,310,7524,10,75240,7524,1,67716,75240
7238370,310,396,11.8,3360,396,1,2964,3360
1.00E+12,310,1535,20.5,7500,1535,1,5965,7500
1.00E+12,200,1535,20.5,7500,1535,1,5965,7500
1.00E+12,200,9661,25,38600,9661,1,28939,38600
1.00E+12,100,221,11.8,1880,221,1,1659,1880
1.00E+12,501,9661,25,38600,9661,1,28939,38600
1.00E+12,501,221,11.8,1880,221,1,1659,1880
2.10E+12,501,433,11.8,3680,433,1,3247,3680
1.00E+12,310,1237,7.7,15980,4948,4,58972,63920
1.00E+12,200,770,2.2,35000,770,1,34230,35000
1.00E+12,100,756,19,3980,756,1,3224,3980
1.00E+12,310,549,8,6890,549,1,6341,6890
7623579,310,794,8,9950,1587,2,18313,19900
1.00E+12,240,248,10,2480,744,3,6696,7440
2.10E+12,200,1434,16.3,8800,1434,1,7366,8800
2.10E+12,340,616,7,8800,616,1,8184,8800
2.10E+12,340,686,7,9800,686,1,9114,9800
8040364,340,166,7,2380,166,1,2214,2380
2.10E+12,100,1479,21.6,6850,1479,1,5371,6850
2.10E+12,500,2199,22,9980,2199,1,7781,9980
1.00E+12,310,314,5,6280,942,3,17898,18840
6610201,310,130,5,2600,780,6,14820,15600
1.00E+12,310,749,5,14980,1498,2,28462,29960
7275213,310,306,7,4380,306,1,4074,4380
1.00E+12,310,348,7,4980,696,2,9264,9960
7530673,310,161,7,2300,161,1,2139,2300
8797937,310,195,8.9,2180,195,1,1985,2180
1.00E+12,310,1697,9,18900,1697,1,17203,18900
1.00E+12,310,1255,9,13980,1255,1,12725,13980
8527105,310,896,9,9980,896,1,9084,9980
1.00E+12,310,349,5,6980,349,1,6631,6980
1.00E+12,300,864,30,2880,864,1,2016,2880
1.00E+12,340,5637,22.5,25000,5637,1,19363,25000
1.00E+12,310,344,5,6880,688,2,13072,13760
7022400,310,761,8,9480,761,1,8719,9480
8333648,310,271,8,3380,271,1,3109,3380
8039735,310,168,8,2100,336,2,3864,4200
2.10E+12,100,1439,8,17900,1439,1,16461,17900
7022400,501,761,8,9480,761,1,8719,9480
1.00E+12,501,400,8,4980,400,1,4580,4980
2.10E+12,501,520,8,6480,520,1,5960,6480
8410586,310,136,5.7,2380,407,3,6733,7140
1.00E+12,310,56,5.7,980,111,2,1849,1960
8843453,240,1375,15,9180,1375,1,7805,9180
1.00E+12,200,1880,10,18800,1880,1,16920,18800
1.00E+12,310,890,10,8900,890,1,8010,8900
1.00E+12,310,990,10,9900,990,1,8910,9900
1.00E+12,310,598,10,5980,1196,2,10764,11960
2.10E+12,310,2625,8.8,29900,2625,1,27275,29900
1.00E+12,310,156,8.8,1780,1560,10,16240,17800
6609413,310,313,8.7,3580,313,1,3267,3580
1.00E+12,310,1384,8.8,15800,1384,1,14416,15800
1.00E+12,501,36883,23.2,159200,36883,1,122317,159200
1.00E+12,310,1245,5,24900,2490,2,47310,49800
1.00E+12,100,34298,22.4,153300,34298,1,119002,153300
1.00E+12,300,180,1,18000,540,3,53460,54000
2.10E+12,310,404,7,5780,808,2,10752,11560
7938700,511,7602,52.5,14480,15204,2,13756,28960
7916439,310,69,6.9,1000,69,1,931,1000
1.00E+12,500,1192,4,29800,1192,1,28608,29800
8367117,310,119,5,2380,238,2,4522,4760
1.00E+12,100,675,11.6,5800,675,1,5125,5800
2.10E+12,200,2771,42,6600,5542,2,7658,13200
2.10E+12,100,2472,21.5,11480,2472,1,9008,11480
8103671,501,66,7.8,850,132,2,1568,1700
1.00E+12,310,2098,7,29980,2098,1,27882,29980
1.00E+12,500,13030,22.1,59000,13030,1,45970,59000
1.00E+12,200,4090,15,27300,8180,2,46420,54600
8886936,310,244,8.5,2880,244,1,2636,2880
1.00E+12,200,1600,3,53500,1600,1,51900,53500
1.00E+12,310,293,9.2,3180,3226,11,31754,34980
1.00E+12,200,2400,15,16000,4800,2,27200,32000
7594661,310,998,10,9980,998,1,8982,9980
1.00E+12,200,5310,10,53100,5310,1,47790,53100
,,,,,,,,
1.00E+12,310,970,10.9,8900,1940,2,15860,17800
1.00E+12,200,990,5,19900,990,1,18910,19900
1.00E+12,310,271,7,3880,542,2,7218,7760
1.00E+12,310,201,7,2880,402,2,5358,5760
1.00E+12,200,3600,20,18000,3600,1,14400,18000
6615244,100,90,5,1800,180,2,3420,3600
10732908,100,149,5,2980,149,1,2831,2980
1.00E+12,100,540,5,10800,540,1,10260,10800
1.00E+12,100,424,5,8480,424,1,8056,8480
1.00E+12,310,553,7,7900,553,1,7347,7900
10457688,310,297,7,4250,297,1,3953,4250
1.00E+12,310,1302,10,13020,2604,2,23436,26040
1.00E+12,310,1296,14.5,8940,1296,1,7644,8940
1.00E+12,100,93,2,4680,93,1,4587,4680
1.00E+12,100,89,2,4490,89,1,4401,4490
1.00E+12,500,7282,12.6,57800,7282,1,50518,57800
2.10E+12,200,1553,15.8,9800,1553,1,8247,9800
6609263,501,35,1,3500,35,1,3465,3500
1.00E+12,310,7424,25.6,29000,7424,1,21576,29000
1.00E+12,310,5888,25.6,23000,5888,1,17112,23000
1.00E+12,100,6300,35.2,17900,12600,2,23200,35800
1.00E+12,310,13279,27.1,49000,13279,1,35721,49000
8232922,340,1295,7,18500,1295,1,17205,18500
7134845,340,271,7,3880,542,2,7218,7760
1.00E+12,310,198,10,1980,198,1,1782,1980
7558817,310,768,10,7680,768,1,6912,7680
2.10E+12,310,82,5,1650,82,1,1568,1650
1.00E+12,200,1980,20,9900,1980,1,7920,9900
1.00E+12,100,148,10,1480,148,1,1332,1480
1.00E+12,100,100,10,1000,100,1,900,1000
1.00E+12,100,98,10,980,196,2,1764,1960
6610289,601,6075,14.5,41900,6075,1,35825,41900
1.00E+12,200,3315,5,66310,3315,1,62995,66310
1.00E+12,501,1133,16.2,7000,1133,1,5867,7000
1.00E+12,310,261,4.2,6280,261,1,6019,6280
1.00E+12,310,353,4.2,8480,353,1,8127,8480
1.00E+12,310,115,4.1,2780,115,1,2665,2780
1.00E+12,501,11,0.9,1180,22,2,2338,2360
6615115,310,893,19,4700,893,1,3807,4700
2.10E+12,601,745,5,14900,1490,2,28310,29800
1.00E+12,200,5940,15,39600,5940,1,33660,39600
1.00E+12,200,51763,20.5,253000,51763,1,201237,253000
8624384,310,220,5,4400,220,1,4180,4400
1.00E+12,200,1210,5.6,21800,1210,1,20590,21800
1.00E+12,100,1012,14.5,6980,1012,1,5968,6980
2.10E+12,100,69,1,6980,69,1,6911,6980
1.00E+12,200,23960,10,239600,23960,1,215640,239600
1.00E+12,310,193,8.1,2380,193,1,2187,2380
2.10E+12,310,242,8.1,2980,242,1,2738,2980
1.00E+12,340,525,7,7500,525,1,6975,7500
9750678,300,5670,30,18900,11340,2,26460,37800
1.00E+12,200,6272,10,62720,6272,1,56448,62720
6616349,310,199,5,3980,398,2,7562,7960
1.00E+12,310,448,10,4480,896,2,8064,8960
1.00E+12,310,348,10,3480,348,1,3132,3480
1.00E+12,500,576,3,19200,576,1,18624,19200
1.00E+12,500,35395,20.5,173000,70790,2,275210,346000
1.00E+12,200,16796,4.9,340000,16796,1,323204,340000
1.00E+12,500,16796,4.9,340000,16796,1,323204,340000
1.00E+12,310,965,9.7,9900,965,1,8935,9900
1.00E+12,310,867,9.7,8900,867,1,8033,8900
1.00E+12,310,867,9.7,8900,867,1,8033,8900
1.00E+12,200,5254,27.8,18900,5254,1,13646,18900
7624169,310,297,5,5950,297,1,5653,5950
6609534,100,471,19,2480,471,1,2009,2480
1.00E+12,100,399,5,7980,399,1,7581,7980
8265786,100,89,5,1780,89,1,1691,1780
1.00E+12,310,347,8.7,3980,347,1,3633,3980
1.00E+12,310,400,8.7,4580,400,1,4180,4580
1.00E+12,310,248,10,2480,248,1,2232,2480
1.00E+12,310,490,10,4900,490,1,4410,4900
1.00E+12,240,693,18.3,3780,693,1,3087,3780
1.00E+12,200,1930,10,19300,1930,1,17370,19300
1.00E+12,300,2000,25.1,7980,2000,1,5980,7980
1.00E+12,240,946,19,4980,2838,3,12102,14940
1.00E+12,205,860,28.9,2980,1720,2,4240,5960
1.00E+12,310,516,7,7380,516,1,6864,7380
10626914,340,1258,7,17980,1258,1,16722,17980
1.00E+12,310,306,7,4380,306,1,4074,4380
1.00E+12,200,1800,10,18000,3600,2,32400,36000
6618348,310,379,6.9,5500,379,1,5121,5500
1.00E+12,310,412,6.9,5980,412,1,5568,5980
2.10E+12,310,191,6.9,2780,191,1,2589,2780
1.00E+12,200,3434,18.1,19000,3434,1,15566,19000
1.00E+12,310,457,6.8,6700,1370,3,18730,20100
1.00E+12,310,759,55,1380,1518,2,1242,2760
10008395,310,74,5,1480,74,1,1406,1480
2.10E+12,310,214,5.5,3900,214,1,3686,3900
2.10E+12,100,449,10.2,4400,449,1,3951,4400
2.10E+12,100,595,14.9,3980,1189,2,6771,7960
1.00E+12,100,36,1,3600,36,1,3564,3600
6609387,100,28,1,2880,28,1,2852,2880
1.00E+12,200,1243,5.9,20900,1243,1,19657,20900
1.00E+12,310,290,10,2900,290,1,2610,2900
1.00E+12,310,3525,23.5,15000,3525,1,11475,15000
1.00E+12,310,673,12.7,5300,673,1,4627,5300
1.00E+12,200,1511,12.7,11900,1511,1,10389,11900
1.00E+12,200,3500,5,70000,3500,1,66500,70000
1.00E+12,310,467,10,4680,7012,15,63188,70200
8249673,310,257,7,3680,257,1,3423,3680
1.00E+12,601,696,10,6980,696,1,6284,6980
1.00E+12,300,5340,30,17800,16020,3,37380,53400
1.00E+12,200,8740,19,46000,8740,1,37260,46000
1.00E+12,310,822,23.5,3500,17262,21,56238,73500
1.00E+12,310,2434,11.6,20900,2434,1,18466,20900
1.00E+12,601,1911,16.1,11900,1911,1,9989,11900
1.00E+12,601,1911,16.1,11900,1911,1,9989,11900
1.00E+12,100,1911,16.1,11900,1911,1,9989,11900
1.00E+12,200,3450,5,69000,3450,1,65550,69000
1.00E+12,500,2930,10.1,28900,11718,4,103882,115600
1.00E+12,310,21585,23.2,93200,21585,1,71615,93200
1.00E+12,100,3002,19,15800,3002,1,12798,15800
1.00E+12,240,9859,38.5,25600,19718,2,31482,51200
1.00E+12,205,9859,38.5,25600,29577,3,47223,76800
1.00E+12,100,9859,38.5,25600,19718,2,31482,51200
8122501,501,89,1,8900,89,1,8811,8900
1.00E+12,500,73160,27.8,263200,73160,1,190040,263200
1.00E+12,200,26390,23.7,111200,26390,1,84810,111200
1.00E+12,500,12430,26,47790,12430,1,35360,47790
1.00E+12,310,371,6.9,5400,371,1,5029,5400
2.10E+12,200,1008,22,4590,1008,1,3582,4590
1.00E+12,511,1583,39.8,3980,9495,6,14385,23880
1.00E+12,310,268,9.6,2780,268,1,2512,2780
1.00E+12,310,1436,9.6,14900,1436,1,13464,14900
1.00E+12,100,1519,14.5,10480,1519,1,8961,10480
1.00E+12,100,1402,19,7380,1402,1,5978,7380
1.00E+12,310,88,9,980,88,1,892,980
8410642,310,178,9,1980,356,2,3604,3960
1.00E+12,310,385,9,4280,385,1,3895,4280
1.00E+12,310,718,9,7980,718,1,7262,7980
1.00E+12,310,1800,9,19900,1800,1,18100,19900
1.00E+12,310,891,9,9900,891,1,9009,9900
1.00E+12,310,196,9,2180,196,1,1984,2180
1.00E+12,310,142,9,1580,284,2,2876,3160
1.00E+12,310,2741,9.8,28000,2741,1,25259,28000
1.00E+12,500,12425,24.9,49900,12425,1,37475,49900
1.00E+12,601,2311,33.5,6900,2311,1,4589,6900
1.00E+12,310,398,10,3980,398,1,3582,3980
1.00E+12,200,8120,14.5,56000,8120,1,47880,56000
1.00E+12,310,167,6,2780,334,2,5226,5560
7117293,310,176,8.1,2180,176,1,2004,2180
8594928,310,157,8.1,1950,157,1,1793,1950
1.00E+12,310,1049,8.2,12800,1049,1,11751,12800
1.00E+12,205,4675,25,18700,4675,1,14025,18700
1.00E+12,310,10064,12,83900,10064,1,73836,83900
6609408,310,87,2.2,3980,87,1,3893,3980
1.00E+12,310,109,2.2,5000,109,1,4891,5000
1.00E+12,310,85,2.2,3900,85,1,3815,3900
1.00E+12,310,427,2.2,19500,427,1,19073,19500
1.00E+12,310,65,2.2,2980,65,1,2915,2980
1.00E+12,240,106,7.1,1500,106,1,1394,1500
1.00E+12,200,10064,12,83900,10064,1,73836,83900
1.00E+12,200,2407,11,21900,2407,1,19493,21900
7922061,310,299,8.1,3680,299,1,3381,3680
6610189,310,76,8.1,940,76,1,864,940
7899562,310,418,38.7,1080,1255,3,1985,3240
1.00E+12,310,234,8.1,2880,234,1,2646,2880
7469562,310,649,8.1,7980,649,1,7331,7980
1.00E+12,240,239,17.3,1380,717,3,3423,4140
1.00E+12,200,4537,22.9,19800,9074,2,30526,39600
10010722,340,292,7,4180,876,3,11664,12540
1.00E+12,340,628,7,8980,628,1,8352,8980
2.10E+12,310,150,8.9,1680,150,1,1530,1680
10151447,200,27025,20.9,129000,27025,1,101975,129000
1.00E+12,340,243,7,3480,243,1,3237,3480
6994808,310,164,5,3290,164,1,3126,3290
1.00E+12,310,399,5,7980,399,1,7581,7980
1.00E+12,200,950,10,9500,1900,2,17100,19000
7513645,310,180,5,3580,180,1,3400,3580
1.00E+12,310,302,5.1,5980,302,1,5678,5980
1.00E+12,200,2246,9.8,22900,2246,1,20654,22900
1.00E+12,200,7462,23.3,32000,7462,1,24538,32000
1.00E+12,200,7350,15,49000,7350,1,41650,49000
1.00E+12,200,7970,20.4,39000,7970,1,31030,39000
1.00E+12,500,5495,23,23900,5495,1,18405,23900
1.00E+12,200,8250,15,55000,8250,1,46750,55000
1.00E+12,200,3100,10,31000,3100,1,27900,31000
1.00E+12,310,229,5,4580,458,2,8702,9160
2.10E+12,310,1235,35.5,3480,2470,2,4490,6960
1.00E+12,310,533,11.6,4580,533,1,4047,4580
1.00E+12,310,871,11.6,7480,871,1,6609,7480
1.00E+12,310,224,16.2,1380,224,1,1156,1380
1.00E+12,601,199,5,3990,199,1,3791,3990
1.00E+12,100,299,5,5980,299,1,5681,5980
1.00E+12,200,890,3,29900,890,1,29010,29900
2.10E+12,100,49,2,2480,49,1,2431,2480
2.10E+12,100,139,2,6980,139,1,6841,6980
2.10E+12,310,7022,37,18980,7022,1,11958,18980
2.10E+12,200,2180,17,12800,4360,2,21240,25600
1.00E+12,340,1580,19.8,7980,6320,4,25600,31920
1.00E+12,200,4563,15,30420,4563,1,25857,30420
1.00E+12,310,378,9.5,3980,378,1,3602,3980
1.00E+12,310,2240,5,44800,2240,1,42560,44800
1.00E+12,310,930,5,18600,930,1,17670,18600
1.00E+12,300,5200,20.8,25000,5200,1,19800,25000
1.00E+12,310,7617,18.8,40500,7617,1,32883,40500
1.00E+12,200,147580,7.9,1880000,147580,1,1732420,1880000
1.00E+12,240,1516,19,7980,3032,2,12928,15960
1.00E+12,100,67,7.6,880,67,1,813,880
6621714,100,539,7.7,6980,539,1,6441,6980
1.00E+12,340,113,7.6,1480,113,1,1367,1480
1.00E+12,340,229,7.7,2980,229,1,2751,2980
1.00E+12,501,307,7.7,3980,307,1,3673,3980
2.10E+12,205,478,25.4,1880,956,2,2804,3760
1.00E+12,310,13677,15.4,89000,13677,1,75323,89000
1.00E+12,200,13677,15.4,89000,13677,1,75323,89000
1.00E+12,310,2135,26.8,7980,2135,1,5845,7980
2.10E+12,310,2081,27.8,7475,4162,2,10788,14950
2.10E+12,205,2543,36.9,6900,2543,1,4357,6900
1.00E+12,100,160,1,16000,160,1,15840,16000
,,,,,,,,
1.00E+12,310,2618,7,37400,2618,1,34782,37400
1.00E+12,100,348,10,3480,348,1,3132,3480
1.00E+12,200,1990,5,39800,1990,1,37810,39800
1.00E+12,310,22500,9,250000,22500,1,227500,250000
1.00E+12,310,760,10,7600,1520,2,13680,15200
1.00E+12,340,256,11.6,2200,768,3,5832,6600
1.00E+12,310,684,7,9780,684,1,9096,9780
8914341,310,3692,53.5,6900,7383,2,6417,13800
2.10E+12,340,815,17.8,4590,815,1,3775,4590
2.10E+12,310,185,7,2650,185,1,2465,2650
1.00E+12,310,3766,14.1,26800,3766,1,23034,26800
2.10E+12,310,3780,28,13500,3780,1,9720,13500
1.00E+12,310,382,6.4,5980,763,2,11197,11960
7050044,310,190,6.4,2980,190,1,2790,2980
9602031,310,798,10,7980,798,1,7182,7980
1.00E+12,500,6517,19,34300,6517,1,27783,34300
7095621,340,199,6.9,2880,199,1,2681,2880
1.00E+12,340,13614,16.2,83900,13614,1,70286,83900
1.00E+12,100,49,1,4950,49,1,4901,4950
1.00E+12,501,19,1,1980,19,1,1961,1980
1.00E+12,310,229,7,3280,229,1,3051,3280
7938693,310,5136,53.5,9600,10272,2,8928,19200
6897442,511,4762,53.5,8900,9523,2,8277,17800
2.10E+12,310,1609,9,17900,1609,1,16291,17900
2.10E+12,200,2520,20.2,12500,2520,1,9980,12500
1.00E+12,100,599,10,5990,599,1,5391,5990
1.00E+12,100,988,10,9880,988,1,8892,9880
1.00E+12,310,99,5,1980,297,3,5643,5940
1.00E+12,310,1990,10,19900,1990,1,17910,19900
1.00E+12,310,1876,7,26800,1876,1,24924,26800
7409770,310,152,7,2180,608,4,8112,8720
1.00E+12,310,783,9.8,7980,783,1,7197,7980
1.00E+12,310,861,9.8,8780,861,1,7919,8780
1.00E+12,310,39,4.9,790,39,1,751,790
1.00E+12,240,755,19,3980,1510,2,6450,7960
1.00E+12,310,1087,10,10900,1087,1,9813,10900
1.00E+12,310,297,10,2980,297,1,2683,2980
1.00E+12,310,194,9.8,1980,194,1,1786,1980
6609553,310,93,9.8,950,186,2,1714,1900
1.00E+12,310,250,9.8,2560,250,1,2310,2560
1.00E+12,310,292,9.8,2980,292,1,2688,2980
1.00E+12,310,488,9.8,4980,488,1,4492,4980
6890809,310,537,9.8,5480,537,1,4943,5480
1.00E+12,310,799,5,15980,1598,2,30362,31960
1.00E+12,511,952,53.5,1780,5712,6,4968,10680
1.00E+12,340,301,7,4300,301,1,3999,4300
1.00E+12,601,494,14.2,3490,494,1,2996,3490
9655526,310,162,9.6,1680,162,1,1518,1680
1.00E+12,310,175,14.1,1240,175,1,1065,1240
8104636,310,336,14.1,2380,336,1,2044,2380
8104634,310,336,14.1,2380,336,1,2044,2380
8038256,310,280,14.1,1980,280,1,1700,1980
8333610,310,407,9.7,4200,814,2,7586,8400
8104634,601,336,14.1,2380,336,1,2044,2380
8104636,100,336,14.1,2380,336,1,2044,2380
8104617,100,230,9.7,2380,230,1,2150,2380
7095585,100,482,9.7,4980,482,1,4498,4980
1.00E+12,501,613,8.8,6980,613,1,6367,6980
7095585,501,482,9.7,4980,482,1,4498,4980
1.00E+12,200,2282,16.3,14000,4564,2,23436,28000
1.00E+12,100,5708,17.3,32900,5708,1,27192,32900
1.00E+12,200,5708,17.3,32900,5708,1,27192,32900
8983477,310,535,11.6,4600,535,1,4065,4600
1.00E+12,310,974,16.3,5980,974,1,5006,5980
1.00E+12,100,974,16.3,5980,974,1,5006,5980
6620571,310,328,10,3280,328,1,2952,3280
6610201,310,257,9.9,2600,257,1,2343,2600
1.00E+12,310,365,9.9,3680,365,1,3315,3680
7234764,310,129,9.8,1310,129,1,1181,1310
1.00E+12,310,5116,19.1,26800,10232,2,43368,53600
1.00E+12,310,348,7,4980,348,1,4632,4980
1.00E+12,100,192731,25,770000,192731,1,577269,770000
1.00E+12,200,192731,25,770000,192731,1,577269,770000
1.00E+12,501,106,10.8,980,106,1,874,980
1.00E+12,100,258,10.8,2380,258,1,2122,2380
8333566,100,542,10.9,4980,542,1,4438,4980
1.00E+12,501,258,10.8,2380,258,1,2122,2380
1.00E+12,501,294,10.9,2700,294,1,2406,2700
1.00E+12,100,59,2,2980,59,1,2921,2980
1.00E+12,200,2397,18.2,13200,4794,2,21606,26400
1.00E+12,310,3120,10,31200,3120,1,28080,31200
1.00E+12,310,10000,2.2,448000,10000,1,438000,448000
1.00E+12,200,4374,6,72900,4374,1,68526,72900
1.00E+12,200,8165,8.3,98000,8165,1,89835,98000
1.00E+12,310,1170,9.1,12800,1170,1,11630,12800
1.00E+12,310,544,5,10880,544,1,10336,10880
1.00E+12,310,1699,5,33980,1699,1,32281,33980
1.00E+12,310,350,10,3500,1050,3,9450,10500
1.00E+12,200,10374,19,54600,10374,1,44226,54600
1.00E+12,205,1194,30,3980,1194,1,2786,3980
1.00E+12,501,18960,4.2,448000,18960,1,429040,448000
1.00E+12,200,11500,16.7,69000,11500,1,57500,69000
1.00E+12,500,530,8.2,6500,530,1,5970,6500
1.00E+12,300,2370,30,7900,2370,1,5530,7900
1.00E+12,310,208,10,2080,208,1,1872,2080
10219983,310,26,6.5,398,156,6,2232,2388
1.00E+12,310,228,6.6,3480,228,1,3252,3480
1.00E+12,310,97,6.6,1480,97,1,1383,1480
1.00E+12,310,188,6.5,2880,188,1,2692,2880
1.00E+12,310,83,6.5,1280,83,1,1197,1280
7509926,100,299,5,5980,299,1,5681,5980
1.00E+12,100,1045,5,20900,1045,1,19855,20900
1.00E+12,310,378,10,3780,378,1,3402,3780
1.00E+12,200,2279,7.6,29900,2279,1,27621,29900
8369741,310,891,9.5,9390,891,1,8499,9390
1.00E+12,310,137,9.4,1450,137,1,1313,1450
8333648,310,321,9.5,3380,321,1,3059,3380
1.00E+12,310,494,9.9,4990,494,1,4496,4990
1.00E+12,310,791,9.9,7980,791,1,7189,7980
1.00E+12,310,2558,9.9,25800,2558,1,23242,25800
7632909,310,432,14.5,2980,432,1,2548,2980
1.00E+12,300,2000,22.3,8980,2000,1,6980,8980
1.00E+12,310,420,5.3,7980,420,1,7560,7980
1.00E+12,310,104,5.3,1980,313,3,5627,5940
1.00E+12,310,420,5.3,7980,420,1,7560,7980
1.00E+12,310,463,6.7,6880,463,1,6417,6880
9656160,310,167,6.7,2480,167,1,2313,2480
8632269,310,342,6.7,5080,342,1,4738,5080
1.00E+12,310,182,10,1820,1092,6,9828,10920
1.00E+12,310,166,9.9,1680,166,1,1514,1680
1.00E+12,500,40403,16.9,239400,40403,1,198997,239400
6609431,310,383,11.7,3280,383,1,2897,3280
2.10E+12,310,243,11.7,2080,243,1,1837,2080
2.10E+12,310,816,11.7,6980,816,1,6164,6980
2.10E+12,310,454,11.7,3880,907,2,6853,7760
2.10E+12,100,614,11.7,5250,614,1,4636,5250
1.00E+12,100,1499,12.6,11900,1499,1,10401,11900
2.10E+12,200,7631,38.2,19980,7631,1,12349,19980
2.10E+12,200,3811,38.2,9980,7622,2,12338,19960
2.10E+12,100,219,11.6,1880,219,1,1661,1880
2.10E+12,100,243,11.7,2080,243,1,1837,2080
1.00E+12,501,583,11.7,4990,583,1,4407,4990
2.10E+12,501,219,11.6,1880,219,1,1661,1880
2.10E+12,501,196,11.7,1680,392,2,2968,3360
2.10E+12,501,4787,26.9,17800,4787,1,13013,17800
2.10E+12,501,465,11.7,3980,465,1,3515,3980
1.00E+12,501,348,11.7,2980,348,1,2632,2980
10219983,100,19,4.8,398,76,4,1516,1592
1.00E+12,100,109,5,2180,109,1,2071,2180
1.00E+12,100,74,5,1480,74,1,1406,1480
1.00E+12,310,20992,16.4,128000,20992,1,107008,128000
1.00E+12,100,395,10,3950,395,1,3555,3950
1.00E+12,100,1090,10,10900,1090,1,9810,10900
1.00E+12,205,3634,46,7900,7268,2,8532,15800
8583223,310,375,7.8,4780,375,1,4405,4780
2.10E+12,100,59,5,1180,59,1,1121,1180
1.00E+12,100,16778,22.2,75600,16778,1,58822,75600
1.00E+12,601,563,9.7,5780,563,1,5217,5780
1.00E+12,310,1090,10,10900,1090,1,9810,10900
,,,,,,,,
1.00E+12,310,1850,5.6,32980,1850,1,31130,32980
1.00E+12,310,398,10,3980,398,1,3582,3980
1.00E+12,310,3734,23,16200,3734,1,12466,16200
1.00E+12,310,4282,57.2,7480,8564,2,6396,14960
8039735,100,304,14.5,2100,304,1,1796,2100
9751187,100,475,14.5,3280,475,1,2805,3280
1.00E+12,310,74,5,1480,74,1,1406,1480
1.00E+12,310,598,10,5980,598,1,5382,5980
1.00E+12,310,232,5.9,3900,232,1,3668,3900
1.00E+12,100,355,5.9,5980,355,1,5625,5980
1.00E+12,601,95,5,1900,95,1,1805,1900
1.00E+12,310,18917,20.9,90300,18917,1,71383,90300
1.00E+12,200,18917,20.9,90300,18917,1,71383,90300
1.00E+12,310,9331,11.6,80100,9331,1,70769,80100
1.00E+12,310,149,5,2980,149,1,2831,2980
10012583,310,1059,16.3,6500,2118,2,10882,13000
7695649,100,161,16.3,990,161,1,829,990
1.00E+12,200,8900,10,89000,8900,1,80100,89000
1.00E+12,310,108,7,1550,216,2,2884,3100
8280883,310,138,7,1980,138,1,1842,1980
1.00E+12,310,299,7,4280,299,1,3981,4280
8114937,310,166,7,2380,332,2,4428,4760
1.00E+12,310,253,7.3,3480,253,1,3227,3480
1.00E+12,310,1813,7,25900,1813,1,24087,25900
1.00E+12,500,1290,6,21500,1290,1,20210,21500
1.00E+12,310,203,7,2900,203,1,2697,2900
1.00E+12,200,8160,17,48000,8160,1,39840,48000
1.00E+12,310,1738,9.2,18980,1738,1,17242,18980
1.00E+12,310,296,9.9,2980,296,1,2684,2980
7156331,310,165,9.9,1670,165,1,1505,1670
1.00E+12,310,2580,10,25800,2580,1,23220,25800
1.00E+12,310,893,16.3,5480,893,1,4587,5480
1.00E+12,310,929,11.6,7980,929,1,7051,7980
2.10E+12,100,312,11.6,2680,312,1,2368,2680
1.00E+12,310,995,5,19900,995,1,18905,19900
8410586,310,196,8.2,2380,196,1,2184,2380
2.10E+12,200,2077,39.3,5280,2077,1,3203,5280
1.00E+12,310,1968,55,3580,3936,2,3224,7160
1.00E+12,310,4388,55,7980,8775,2,7185,15960
1.00E+12,511,1968,55,3580,3936,2,3224,7160
1.00E+12,310,171,8.6,1980,171,1,1809,1980
9707916,310,240,8.6,2780,240,1,2540,2780
1.00E+12,310,85,8.6,990,85,1,905,990
1.00E+12,200,381,17.3,2200,1143,3,5457,6600
8782084,310,657,6.6,9900,657,1,9243,9900
1.00E+12,310,4866,20.7,23500,4866,1,18634,23500
8102706,310,995,5,19900,995,1,18905,19900
1.00E+12,310,211,7.1,2980,211,1,2769,2980
1.00E+12,100,495,5,9900,495,1,9405,9900
1.00E+12,100,3565,10.5,34000,3565,1,30435,34000
1.00E+12,310,124,7,1780,124,1,1656,1780
1.00E+12,310,428,10,4280,856,2,7704,8560
1.00E+12,310,658,16.5,3980,658,1,3322,3980
10614227,310,356,9.9,3580,356,1,3224,3580
1.00E+12,240,490,10,4900,980,2,8820,9800
1.00E+12,310,166,7,2380,166,1,2214,2380
1.00E+12,200,83000,11.4,730000,83000,1,647000,730000
1.00E+12,100,1395,11.6,11980,1395,1,10585,11980
1.00E+12,100,938,16.3,5760,938,1,4822,5760
1.00E+12,205,1376,32,4300,1376,1,2924,4300
1.00E+12,310,594,9.9,5980,594,1,5386,5980
1.00E+12,310,157,9.9,1580,313,2,2847,3160
1.00E+12,310,283,7.9,3590,283,1,3307,3590
1.00E+12,310,473,7.9,5980,473,1,5507,5980
1.00E+12,310,201,7,2880,201,1,2679,2880
1.00E+12,100,869,7.9,10980,869,1,10111,10980
1.00E+12,100,441,7.9,5580,441,1,5139,5580
1.00E+12,100,864,7.9,10900,864,1,10036,10900
1.00E+12,501,118,7.9,1500,118,1,1382,1500
9654374,501,418,7,5980,418,1,5562,5980
1.00E+12,100,9898,7.7,129000,9898,1,119102,129000
1.00E+12,501,8560,53.8,15900,17119,2,14681,31800
2.10E+12,310,470,9.4,5000,1410,3,13590,15000
1.00E+12,200,1300,2.2,58900,1300,1,57600,58900
1.00E+12,240,1464,50.5,2900,11712,8,11488,23200
1.00E+12,240,1464,50.5,2900,11712,8,11488,23200
1.00E+12,100,39,1,3980,39,1,3941,3980
1.00E+12,300,7610,10,76100,7610,1,68490,76100
1.00E+12,310,767,7.8,9880,767,1,9113,9880
1.00E+12,310,355,7.8,4580,355,1,4225,4580
1.00E+12,310,613,7.8,7900,613,1,7287,7900
1.00E+12,310,368,7.7,4750,368,1,4382,4750
8315731,601,139,5,2780,139,1,2641,2780
2.10E+12,310,730,10.9,6700,730,1,5970,6700
2.10E+12,200,302,18.6,1620,1208,4,5272,6480
8038256,501,215,10.9,1980,430,2,3530,3960
8937157,310,736,8.7,8480,736,1,7744,8480
7069187,310,1080,24,4500,2160,2,6840,9000
7691348,310,705,7.9,8880,705,1,8175,8880
1.00E+12,240,2696,21.7,12400,2696,1,9704,12400
1.00E+12,300,7335,16.3,45000,7335,1,37665,45000
8333662,240,522,19,2750,522,1,2228,2750
1.00E+12,310,748,10,7480,748,1,6732,7480
1.00E+12,310,1603,7,22900,1603,1,21297,22900
1.00E+12,500,223,7.8,2860,223,1,2637,2860
1.00E+12,100,1198,10,11980,1198,1,10782,11980
1.00E+12,310,2090,10,20900,2090,1,18810,20900
2.10E+12,340,110,7,1580,110,1,1470,1580
1.00E+12,310,5361,17.9,29900,5361,1,24539,29900
1.00E+12,310,586,7,8380,1172,2,15588,16760
1.00E+12,310,348,7,4980,348,1,4632,4980
1.00E+12,501,34,10,340,680,20,6120,6800
6609254,501,590,11.8,5000,590,1,4410,5000
10043087,501,764,11.8,6480,764,1,5716,6480
1.00E+12,310,632,7.9,7980,632,1,7348,7980
8023235,100,76,7.8,980,76,1,904,980
1.00E+12,501,632,7.9,7980,632,1,7348,7980
1.00E+12,310,460,5,9200,460,1,8740,9200
2.10E+12,310,1670,10,16700,3340,2,30060,33400
1.00E+12,200,500,10,5000,500,1,4500,5000
2.10E+12,310,1698,21.3,7980,1698,1,6282,7980
9706074,310,770,9.6,7980,770,1,7210,7980
9595783,310,963,9.6,9980,963,1,9017,9980
1.00E+12,310,364,9.6,3780,364,1,3416,3780
9592840,100,580,11.6,4980,1160,2,8800,9960
1.00E+12,310,498,10,4980,498,1,4482,4980
1.00E+12,205,800,28.8,2780,800,1,1980,2780
8333547,310,548,10,5480,548,1,4932,5480
1.00E+12,310,13865,23.5,59000,13865,1,45135,59000
1.00E+12,310,432,14.5,2980,864,2,5096,5960
2.10E+12,200,2200,10,22000,2200,1,19800,22000
1.00E+12,310,817,23.5,3480,1634,2,5326,6960
1.00E+12,310,78,10,780,156,2,1404,1560
9526017,310,168,10,1680,2016,12,18144,20160
1.00E+12,310,103,11.7,880,206,2,1554,1760
6845375,310,539,11.8,4580,1078,2,8082,9160
1.00E+12,310,339,11.8,2880,339,1,2541,2880
1.00E+12,501,339,11.8,2880,339,1,2541,2880
6615248,310,159,6.9,2300,159,1,2141,2300
2.10E+12,310,403,6.9,5800,403,1,5397,5800
2.10E+12,310,2028,12.8,15800,2028,1,13772,15800
1.00E+12,310,688,6.9,9900,688,1,9212,9900
1.00E+12,310,118,8.6,1380,118,1,1262,1380
1.00E+12,310,144,8.6,1680,144,1,1536,1680
6609438,310,221,8.6,2580,221,1,2359,2580
1.00E+12,511,4061,54.3,7480,8121,2,6839,14960
8227172,601,168,13.1,1280,168,1,1112,1280
1.00E+12,205,5113,25.7,19900,5113,1,14787,19900
1.00E+12,200,14687,19.2,76300,14687,1,61613,76300
1.00E+12,200,2950,10,29500,2950,1,26550,29500
1.00E+12,310,648,10,6480,648,1,5832,6480
1.00E+12,300,1386,1,138600,1386,1,137214,138600
1.00E+12,310,149,5,2980,149,1,2831,2980
1.00E+12,200,4250,17,25000,4250,1,20750,25000
2.10E+12,310,390,7,5580,780,2,10380,11160
1.00E+12,310,1598,10,15980,4794,3,43146,47940
1.00E+12,200,54870,27.8,197400,54870,1,142530,197400
2.10E+12,310,407,9.1,4480,407,1,4073,4480
2.10E+12,310,3070,25.6,11980,3070,1,8910,11980
1.00E+12,310,327,9.1,3600,327,1,3273,3600
2.10E+12,200,2634,29.3,8980,2634,1,6346,8980
1.00E+12,200,9199,18.8,49000,9199,1,39801,49000
2.10E+12,310,142,9.6,1480,142,1,1338,1480
7238370,310,324,9.6,3360,324,1,3036,3360
1.00E+12,310,144,9.6,1500,144,1,1356,1500
1.00E+12,240,687,27.7,2480,1374,2,3586,4960
1.00E+12,310,49,5,980,98,2,1862,1960
1.00E+12,100,79,1,7980,79,1,7901,7980
1.00E+12,100,30,1,3000,30,1,2970,3000
1.00E+12,501,118,1,11800,118,1,11682,11800
8333648,501,33,1,3380,33,1,3347,3380
1.00E+12,310,3016,20.9,14400,3016,1,11384,14400
1.00E+12,310,7987,16.3,49000,7987,1,41013,49000
7580677,601,635,14.5,4380,635,1,3745,4380
1.00E+12,310,1258,7,17980,1258,1,16722,17980
1.00E+12,310,453,7,6480,453,1,6027,6480
1.00E+12,310,105,7,1500,105,1,1395,1500
1.00E+12,310,545,5,10900,545,1,10355,10900
6611057,310,257,7,3680,257,1,3423,3680
1.00E+12,205,1194,30,3980,1194,1,2786,3980
8573283,310,170,6.6,2580,170,1,2410,2580
10532298,310,274,5,5480,274,1,5206,5480
1.00E+12,200,4321,14.5,29800,4321,1,25479,29800
1.00E+12,205,2000,20.2,9900,2000,1,7900,9900
6614133,310,450,10,4500,450,1,4050,4500
1.00E+12,310,162,5,3240,972,6,18468,19440
6609765,310,1516,19,7980,4548,3,19392,23940
1.00E+12,310,528,19,2780,1584,3,6756,8340
1.00E+12,100,722,14.5,4980,722,1,4258,4980
1.00E+12,310,490,8.2,5950,490,1,5460,5950
1.00E+12,310,980,8.2,11900,980,1,10920,11900
8333648,310,277,8.2,3380,277,1,3103,3380
2.10E+12,310,550,37.9,1450,550,1,900,1450
1.00E+12,100,980,8.2,11900,980,1,10920,11900
1.00E+12,100,325,8.2,3950,325,1,3625,3950
1.00E+12,100,605,17.4,3480,605,1,2875,3480
1.00E+12,310,422,9.2,4580,422,1,4158,4580
1.00E+12,200,7261,27.4,26500,7261,1,19239,26500
1.00E+12,200,3000,20,15000,3000,1,12000,15000
1.00E+12,310,269,9.3,2900,538,2,5262,5800
1.00E+12,310,1390,9.3,14900,1390,1,13510,14900
1.00E+12,310,92,9.2,1000,92,1,908,1000
1.00E+12,310,695,5,13900,1390,2,26410,27800
1.00E+12,310,1791,10,17980,1791,1,16189,17980
1.00E+12,310,2593,10,25980,2593,1,23387,25980
6609253,310,499,5,9980,499,1,9481,9980
1.00E+12,310,59,7.4,800,59,1,741,800
2.10E+12,310,139,7.4,1880,139,1,1741,1880
2.10E+12,310,95,7.4,1280,95,1,1185,1280
1.00E+12,310,496,7.4,6680,496,1,6184,6680
1.00E+12,310,430,10,4300,430,1,3870,4300
1.00E+12,310,278,10,2780,278,1,2502,2780
1.00E+12,100,298,10,2980,298,1,2682,2980
1.00E+12,500,14040,17.6,80000,14040,1,65960,80000
1.00E+12,200,5850,15,39000,5850,1,33150,39000
1.00E+12,310,413,18.8,2200,413,1,1787,2200
1.00E+12,310,353,14.1,2500,1413,4,8587,10000
1.00E+12,200,847,14.1,6000,847,1,5153,6000
9653149,310,138,7,1980,138,1,1842,1980
2.10E+12,100,4740,13.6,34800,4740,1,30060,34800
1.00E+12,200,6000,20,30000,6000,1,24000,30000
2.10E+12,310,208,7,2980,208,1,2772,2980
2.10E+12,310,488,7,6980,488,1,6492,6980
1.00E+12,200,12640,20,63200,12640,1,50560,63200
1.00E+12,500,4095,15,27300,4095,1,23205,27300
1.00E+12,601,239,5,4780,239,1,4541,4780
1.00E+12,601,239,5,4780,239,1,4541,4780
,,,,,,,,
,,,,,,,,
8305728,310,192,10,1920,192,1,1728,1920
8976071,310,390,10,3900,1560,4,14040,15600
1.00E+12,500,5250,5,105000,5250,1,99750,105000
1.00E+12,300,12714,16.3,78000,12714,1,65286,78000
1.00E+12,200,12170,20.5,59500,12170,1,47330,59500
7216767,310,566,9.5,5950,566,1,5384,5950
1.00E+12,310,207,9.5,2180,207,1,1973,2180
1.00E+12,310,190,9.5,2000,380,2,3620,4000
8573282,310,331,9.5,3480,331,1,3149,3480
6613872,240,317,17.7,1790,317,1,1473,1790
2.10E+12,310,87,7,1250,87,1,1163,1250
1.00E+12,310,17982,15.1,119000,17982,1,101018,119000
1.00E+12,310,3918,5.7,69000,3918,1,65082,69000
8055361,340,454,5.2,8800,454,1,8346,8800
1.00E+12,340,154,5.2,2980,154,1,2826,2980
1.00E+12,340,257,5.2,4980,257,1,4723,4980
1.00E+12,340,387,5.2,7500,387,1,7113,7500
1.00E+12,340,253,5.2,4900,253,1,4647,4900
7186745,340,903,5.2,17480,903,1,16577,17480
1.00E+12,340,205,5.2,3980,205,1,3775,3980
1.00E+12,340,129,5.2,2500,129,1,2371,2500
1.00E+12,340,1178,5.2,22800,1178,1,21622,22800
1.00E+12,340,195,5.2,3780,195,1,3585,3780
1.00E+12,310,1100,10,11000,1100,1,9900,11000
1.00E+12,310,358,10,3580,358,1,3222,3580
1.00E+12,310,406,14.5,2800,4060,10,23940,28000
7141873,310,348,7,4980,348,1,4632,4980
1.00E+12,310,674,9.8,6880,674,1,6206,6880
1.00E+12,310,517,9.8,5280,517,1,4763,5280
1.00E+12,511,5157,52.1,9900,10314,2,9486,19800
2.10E+12,200,2093,28,7475,4186,2,10764,14950
1.00E+12,200,1395,5,27900,1395,1,26505,27900
6610093,310,104,5,2080,208,2,3952,4160
7698440,310,460,8.8,5200,460,1,4740,5200
6615130,100,113,2,5650,113,1,5537,5650
8352264,501,69,2,3480,69,1,3411,3480
1.00E+12,501,69,2,3480,69,1,3411,3480
6618348,310,550,10,5500,1100,2,9900,11000
2.10E+12,310,85,4.3,1980,85,1,1895,1980
2.10E+12,310,344,4.3,7980,344,1,7636,7980
6615248,310,99,4.3,2300,99,1,2201,2300
2.10E+12,310,154,4.3,3580,154,1,3426,3580
6871988,310,180,8.6,2100,2163,12,23037,25200
1.00E+12,200,2000,5,40000,2000,1,38000,40000
8350710,100,23,1,2390,23,1,2367,2390
1.00E+12,200,3078,10.7,28900,3078,1,25822,28900
1.00E+12,100,19,1,1980,19,1,1961,1980
8309816,100,11,0.9,1180,11,1,1169,1180
6615532,100,29,1,2980,29,1,2951,2980
1.00E+12,501,47,1,4780,47,1,4733,4780
6615532,501,29,1,2980,29,1,2951,2980
7021292,310,750,10,7500,750,1,6750,7500
6615597,310,230,5,4600,230,1,4370,4600
2.10E+12,310,390,10,3900,390,1,3510,3900
2.10E+12,340,215,11.6,1850,215,1,1635,1850
1.00E+12,100,314,7.9,3980,628,2,7332,7960
1.00E+12,100,261,7.9,3300,261,1,3039,3300
1.00E+12,501,261,7.9,3300,261,1,3039,3300
7530016,310,89,5,1780,89,1,1691,1780
1.00E+12,310,299,9.5,3150,299,1,2851,3150
8570314,310,597,9.5,6280,1193,2,11367,12560
1.00E+12,310,212,9.5,2240,212,1,2028,2240
1.00E+12,310,748,9.5,7880,748,1,7132,7880
1.00E+12,200,6310,15,42100,6310,1,35790,42100
1.00E+12,310,1046,9.7,10800,1046,1,9754,10800
1.00E+12,100,578,9.7,5980,578,1,5402,5980
1.00E+12,100,189,9.7,1950,377,2,3523,3900
8225926,100,339,9.7,3500,339,1,3161,3500
7408194,501,384,9.6,3980,384,1,3596,3980
2.10E+12,501,1230,8.8,13900,1230,1,12670,13900
1.00E+12,100,895,5,17900,895,1,17005,17900
6615155,310,173,8.7,1980,173,1,1807,1980
2.10E+12,310,48,8.7,550,865,18,9035,9900
1.00E+12,200,2380,5,47700,2380,1,45320,47700
1.00E+12,310,898,10,8980,898,1,8082,8980
1.00E+12,310,110,7,1580,110,1,1470,1580
1.00E+12,310,794,9.9,7980,794,1,7186,7980
1.00E+12,511,1363,55,2480,2726,2,2234,4960
1.00E+12,310,147,9.9,1480,147,1,1333,1480
1.00E+12,310,293,9.9,2950,293,1,2657,2950
1.00E+12,310,1195,5,23900,1195,1,22705,23900
2.10E+12,310,335,5,6700,335,1,6365,6700
6613094,310,160,5,3200,160,1,3040,3200
1.00E+12,310,598,10,5980,1196,2,10764,11960
1.00E+12,205,2790,28.2,9900,2790,1,7110,9900
1.00E+12,500,11554,10.9,106000,11554,1,94446,106000
1.00E+12,310,399,5,7980,798,2,15162,15960
2.10E+12,310,687,20.9,3280,687,1,2593,3280
8519792,310,548,10,5480,548,1,4932,5480
2.10E+12,310,2119,36,5880,2119,1,3761,5880
1.00E+12,310,430,8.6,4980,859,2,9101,9960
2.10E+12,310,145,8.6,1680,145,1,1535,1680
1.00E+12,310,171,8.6,1980,512,3,5428,5940
1.00E+12,310,128,10,1280,384,3,3456,3840
1.00E+12,310,640,10,6400,640,1,5760,6400
1.00E+12,310,228,10,2280,228,1,2052,2280
7348243,310,8080,18.4,43900,16160,2,71640,87800
1.00E+12,200,10290,15,68600,10290,1,58310,68600
8634542,310,270,4.9,5480,270,1,5210,5480
8953588,310,799,11.8,6780,799,1,5981,6780
9654373,100,197,11.7,1680,197,1,1483,1680
6615204,100,764,11.8,6480,764,1,5716,6480
2.10E+12,310,174,5,3480,174,1,3306,3480
8025923,310,346,7,4950,346,1,4604,4950
1.00E+12,100,15802,46.9,33700,47407,3,53693,101100
2.10E+12,340,628,7,8980,628,1,8352,8980
1.00E+12,200,3000,10,30000,3000,1,27000,30000
9068152,310,524,5,10480,524,1,9956,10480
7164497,310,189,5,3780,189,1,3591,3780
1.00E+12,310,398,10,3980,398,1,3582,3980
1.00E+12,100,1190,10,11900,1190,1,10710,11900
6613112,310,235,7.9,2980,235,1,2745,2980
1.00E+12,310,275,7.9,3480,275,1,3205,3480
1.00E+12,310,346,7.9,4380,346,1,4034,4380
1.00E+12,310,632,7.9,7980,632,1,7348,7980
1.00E+12,310,552,7.9,6980,552,1,6428,6980
6609572,100,116,7.8,1480,116,1,1364,1480
6609572,501,116,7.8,1480,116,1,1364,1480
1.00E+12,501,394,7.9,4980,394,1,4586,4980
8090958,501,148,7.9,1880,148,1,1732,1880
7694532,501,404,7.9,5100,404,1,4696,5100
1.00E+12,501,180,7.9,2280,1080,6,12600,13680
1.00E+12,310,901,9.8,9200,901,1,8299,9200
1.00E+12,310,977,9.8,9980,977,1,9003,9980
1.00E+12,310,86,7.3,1180,1544,18,19696,21240
2.10E+12,310,1865,17.6,10600,1865,1,8735,10600
2.10E+12,310,612,17.6,3480,612,1,2868,3480
2.10E+12,310,158,8.4,1880,158,1,1722,1880
2.10E+12,310,707,8.4,8380,707,1,7673,8380
7150833,100,638,11.6,5480,638,1,4842,5480
1.00E+12,310,4572,12.7,36000,4572,1,31428,36000
1.00E+12,200,4572,12.7,36000,4572,1,31428,36000
1.00E+12,340,70,7,1000,140,2,1860,2000
10698740,310,671,7.9,8480,671,1,7809,8480
1.00E+12,501,208,7,2980,208,1,2772,2980
1.00E+12,200,1281,14.2,9000,1281,1,7719,9000
1.00E+12,200,1281,14.2,9000,1281,1,7719,9000
1.00E+12,310,126,7,1800,252,2,3348,3600
1.00E+12,310,348,7,4980,696,2,9264,9960
7151321,310,68,6.9,980,68,1,912,980
8323450,310,59,6.9,850,59,1,791,850
1.00E+12,310,229,7,3280,229,1,3051,3280
1.00E+12,100,9652,9.7,99000,9652,1,89348,99000
1.00E+12,310,64939,11.6,560000,64939,1,495061,560000
7051239,310,228,11.8,1940,228,1,1712,1940
1.00E+12,100,292,11.8,2480,292,1,2188,2480
1.00E+12,100,1758,11.8,14900,1758,1,13142,14900
1.00E+12,200,1940,9.7,19900,1940,1,17960,19900
7022294,310,270,10,2700,270,1,2430,2700
1.00E+12,310,9880,19,52000,9880,1,42120,52000
1.00E+12,200,9880,19,52000,9880,1,42120,52000
1.00E+12,310,271,7,3880,271,1,3609,3880
2.10E+12,310,1999,34.9,5730,1999,1,3731,5730
1.00E+12,310,216,8.7,2480,216,1,2264,2480
1.00E+12,310,277,8.7,3180,277,1,2903,3180
1.00E+12,310,347,8.7,3980,347,1,3633,3980
1.00E+12,310,1313,9.7,13580,1313,1,12267,13580
1.00E+12,310,1158,9.7,11980,1158,1,10822,11980
2.10E+12,310,1429,9.6,14900,1429,1,13471,14900
1.00E+12,310,1045,55,1900,2090,2,1710,3800
1.00E+12,310,2451,19,12900,2451,1,10449,12900
1.00E+12,310,868,18.1,4800,1736,2,7864,9600
1.00E+12,200,3329,13.6,24480,3329,1,21151,24480
8055798,310,798,10,7980,798,1,7182,7980
1.00E+12,200,940,10,9400,940,1,8460,9400
1.00E+12,240,648,16.3,3980,648,1,3332,3980
1.00E+12,310,3412,34.9,9780,3412,1,6368,9780
1.00E+12,310,1403,8.8,16000,1403,1,14597,16000
1.00E+12,205,3412,34.9,9780,3412,1,6368,9780
1.00E+12,310,201,7,2880,201,1,2679,2880
1.00E+12,205,1195,24,4980,2390,2,7570,9960
7541096,310,910,7,13000,1820,2,24180,26000
1.00E+12,310,166,7,2380,332,2,4428,4760
1.00E+12,200,23800,5,476000,23800,1,452200,476000
1.00E+12,100,2180,10,21800,2180,1,19620,21800
10229292,100,398,10,3980,398,1,3582,3980
8527107,310,838,7,11980,838,1,11142,11980
1.00E+12,310,382,8.7,4390,382,1,4008,4390
1.00E+12,310,146,8.7,1680,146,1,1534,1680
1.00E+12,100,133,7,1900,133,1,1767,1900
1.00E+12,310,1428,14.6,9780,1428,1,8352,9780
1.00E+12,200,3610,19,19000,3610,1,15390,19000
2.10E+12,340,411,7,5880,411,1,5469,5880
1.00E+12,340,1953,24.5,7980,1953,1,6027,7980
8646828,310,902,9,9980,902,1,9078,9980
,,,,,,,,
8491497,340,312,4.9,6400,312,1,6088,6400
1.00E+12,200,3480,15,23200,3480,1,19720,23200
1.00E+12,500,460,19.9,2310,460,1,1850,2310
1.00E+12,500,270,19,1420,270,1,1150,1420
2.10E+12,310,7274,36.4,19980,7274,1,12706,19980
2.10E+12,200,7269,36.4,19980,7269,1,12711,19980
1.00E+12,300,6840,14.4,47400,6840,1,40560,47400
1.00E+12,100,4417,55.3,7980,8833,2,7127,15960
7632909,340,485,16.3,2980,485,1,2495,2980
1.00E+12,340,376,7,5380,376,1,5004,5380
7647740,310,1086,10,10860,1086,1,9774,10860
1.00E+12,310,119,5,2380,238,2,4522,4760
1.00E+12,310,268,10,2680,536,2,4824,5360
1.00E+12,310,1403,9.7,14480,1403,1,13077,14480
1.00E+12,601,3149,32.2,9780,3149,1,6631,9780
2.10E+12,310,229,14.5,1580,229,1,1351,1580
2.10E+12,100,287,14.5,1980,287,1,1693,1980
1.00E+12,205,12453,41,30400,37360,3,53840,91200
1.00E+12,511,4114,55,7480,8228,2,6732,14960
10472598,310,988,10,9880,988,1,8892,9880
9017976,310,720,9,7980,720,1,7260,7980
1.00E+12,200,39091,13.5,288500,39091,1,249409,288500
1.00E+12,300,39091,13.5,288500,39091,1,249409,288500
1.00E+12,310,488,9.8,4980,488,1,4492,4980
1.00E+12,310,390,9.8,3980,390,1,3590,3980
6815713,310,252,9.8,2580,252,1,2328,2580
8040364,310,233,9.8,2380,466,2,4294,4760
8104762,310,194,9.8,1980,194,1,1786,1980
1.00E+12,200,3624,22.1,16400,3624,1,12776,16400
6609062,310,100,10,1000,100,1,900,1000
1.00E+12,310,698,10,6980,698,1,6282,6980
1.00E+12,601,417,14.5,2880,417,1,2463,2880
1.00E+12,310,185,7.8,2380,185,1,2195,2380
7081031,310,85,7.7,1100,85,1,1015,1100
8333662,310,214,7.8,2750,214,1,2536,2750
10717442,310,302,7.8,3880,302,1,3578,3880
1.00E+12,310,154,7.7,1990,154,1,1836,1990
7210328,310,295,7.8,3800,295,1,3505,3800
8117934,310,448,8.5,5280,448,1,4832,5280
2.10E+12,310,640,8.5,7480,1279,2,13681,14960
1.00E+12,310,847,8.5,9980,847,1,9133,9980
1.00E+12,310,388,8.5,4580,388,1,4192,4580
1.00E+12,310,4340,21.7,20000,4340,1,15660,20000
1.00E+12,310,119,5,2380,119,1,2261,2380
6612826,310,115,5,2300,115,1,2185,2300
1.00E+12,310,1447,14.5,9980,2894,2,17066,19960
1.00E+12,310,5358,13.7,39000,5358,1,33642,39000
1.00E+12,310,14840,21.4,69300,14840,1,54460,69300
10614227,310,519,14.5,3580,519,1,3061,3580
7445509,100,473,19,2490,946,2,4034,4980
10614227,100,519,14.5,3580,519,1,3061,3580
1.00E+12,100,1194,14.5,8240,1194,1,7046,8240
2.10E+12,200,1350,30,4500,13500,10,31500,45000
1.00E+12,310,1190,10,11900,1190,1,10710,11900
1.00E+12,300,7000,41.4,16900,7000,1,9900,16900
6810933,310,790,10,7900,790,1,7110,7900
8094408,310,291,9.2,3150,1163,4,11437,12600
8694843,310,459,9.2,4980,459,1,4521,4980
1.00E+12,100,1860,42.3,4400,1860,1,2540,4400
7934460,340,839,44.2,1900,5036,6,6364,11400
2.10E+12,310,516,7.4,6980,516,1,6464,6980
7264179,310,974,7.4,13180,974,1,12206,13180
2.10E+12,310,249,7.4,3380,249,1,3131,3380
1.00E+12,310,1101,7.4,14900,1101,1,13799,14900
1.00E+12,200,782,16.3,4800,4692,6,24108,28800
1.00E+12,300,119,1,11900,476,4,47124,47600
1.00E+12,340,570,16.3,3500,1710,3,8790,10500
1.00E+12,100,463,11.6,3980,463,1,3517,3980
1.00E+12,100,570,16.3,3500,1710,3,8790,10500
1.00E+12,310,6360,12.3,51500,12720,2,90280,103000
1.00E+12,310,456,9.2,4950,456,1,4494,4950
8581868,310,405,9.2,4400,405,1,3995,4400
2.10E+12,310,1459,24.4,5980,2917,2,9043,11960
2.10E+12,310,182,9.2,1980,182,1,1798,1980
7901414,310,138,7,1980,138,1,1842,1980
2.10E+12,310,195,9.8,1980,195,1,1785,1980
1.00E+12,100,29,5,580,58,2,1102,1160
6608959,100,341,10,3410,341,1,3069,3410
1.00E+12,310,182,10.8,1680,182,1,1498,1680
1.00E+12,310,1951,10.9,17900,1951,1,15949,17900
1.00E+12,340,1505,7,21500,1505,1,19995,21500
8333566,100,587,11.8,4980,1174,2,8786,9960
1.00E+12,310,702,5.9,11800,702,1,11098,11800
1.00E+12,100,702,5.9,11800,702,1,11098,11800
1.00E+12,310,2397,24,9980,2397,1,7583,9980
1.00E+12,100,5656,31.6,17900,5656,1,12244,17900
7242787,100,378,9.7,3880,378,1,3502,3880
7263444,100,271,9.7,2780,271,1,2509,2780
8225168,100,388,9.7,3980,776,2,7184,7960
1.00E+12,310,211,2.2,9680,422,2,18938,19360
1.00E+12,200,26000,5,520000,26000,1,494000,520000
1.00E+12,200,3200,10,32000,3200,1,28800,32000
8069282,310,234,9.4,2500,234,1,2266,2500
1.00E+12,500,3080,16.3,18900,3080,1,15820,18900
8486451,310,394,5.6,7000,3936,10,66064,70000
8641480,310,758,5.6,13480,6064,8,101776,107840
1.00E+12,500,1388,8,17350,1388,1,15962,17350
1.00E+12,310,98,10,980,98,1,882,980
7712800,100,76,2,3800,76,1,3724,3800
1.00E+12,100,204,2,10200,204,1,9996,10200
2.10E+12,200,5990,30,19980,5990,1,13990,19980
1.00E+12,100,29,1,2980,29,1,2951,2980
1.00E+12,310,318,10,3180,318,1,2862,3180
1.00E+12,310,299,5,5980,299,1,5681,5980
1.00E+12,310,235,9.5,2480,235,1,2245,2480
1.00E+12,310,2795,5,55900,5590,2,106210,111800
1.00E+12,310,624,5,12480,624,1,11856,12480
1.00E+12,310,545,5,10900,545,1,10355,10900
1.00E+12,100,818,10.3,7980,818,1,7162,7980
7161178,310,295,5,5900,590,2,11210,11800
1.00E+12,340,558,7,7980,558,1,7422,7980
1.00E+12,310,878,10,8780,878,1,7902,8780
1.00E+12,310,1003,19,5280,2006,2,8554,10560
1.00E+12,300,1176,20,5880,2352,2,9408,11760
1.00E+12,240,1100,10,11000,1100,1,9900,11000
1.00E+12,310,7754,10.8,71500,7754,1,63746,71500
1.00E+12,501,10420,5.9,176041,10420,1,165621,176041
1.00E+12,310,1780,20.9,8500,1780,1,6720,8500
1.00E+12,200,1780,20.9,8500,1780,1,6720,8500
1.00E+12,310,584,7.1,8280,584,1,7696,8280
1.00E+12,310,210,7,2980,210,1,2770,2980
8090941,310,399,8.3,4780,797,2,8763,9560
1.00E+12,200,423514,18.4,2297300,423514,1,1873786,2297300
1.00E+12,100,15,1,1500,15,1,1485,1500
8070178,100,21,1,2100,42,2,4158,4200
7424116,501,78,1,7800,156,2,15444,15600
8055821,501,95,1,9500,95,1,9405,9500
8070178,501,21,1,2100,42,2,4158,4200
1.00E+12,240,390,10,3900,390,1,3510,3900
2.10E+12,100,849,32.9,2580,3396,4,6924,10320
10732911,240,163,16.6,980,326,2,1634,1960
1.00E+12,310,87,7.4,1180,873,10,10927,11800
1.00E+12,310,479,7.4,6480,479,1,6001,6480
7456274,100,823,11.8,6980,823,1,6157,6980
1.00E+12,100,29,2,1480,58,2,2902,2960
1.00E+12,310,313,7,4480,626,2,8334,8960
1.00E+12,200,1647,9.7,16900,1647,1,15253,16900
1.00E+12,200,16860,24.4,69000,16860,1,52140,69000
1.00E+12,200,30084,23.3,129000,30084,1,98916,129000
6615925,310,508,10,5080,508,1,4572,5080
1.00E+12,310,454,8.3,5480,1362,3,15078,16440
1.00E+12,310,1062,8.2,12880,1062,1,11818,12880
8634217,310,476,8.2,5780,476,1,5304,5780
1.00E+12,240,1440,5,28800,4320,3,82080,86400
2.10E+12,205,7735,40.8,18980,15470,2,22490,37960
1.00E+12,310,798,10,7980,798,1,7182,7980
1.00E+12,310,149,11.6,1280,149,1,1131,1280
1.00E+12,310,347,11.6,2980,347,1,2633,2980
1.00E+12,310,521,11.6,4480,521,1,3959,4480
7501565,310,1046,11.6,8980,1046,1,7934,8980
8593946,310,419,11.6,3600,419,1,3181,3600
1.00E+12,601,347,11.6,2980,694,2,5266,5960
1.00E+12,601,347,11.6,2980,347,1,2633,2980
8068394,601,114,11.6,980,114,1,866,980
8333645,601,95,11.6,820,95,1,725,820
7234761,310,376,19,1980,376,1,1604,1980
1.00E+12,310,908,19,4780,908,1,3872,4780
1.00E+12,310,68,6.9,980,68,1,912,980
1.00E+12,100,249,5,4980,249,1,4731,4980
1.00E+12,300,32155,10.9,295000,32155,1,262845,295000
7424116,310,390,5,7800,390,1,7410,7800
1.00E+12,310,761,9.5,7980,1522,2,14438,15960
2.10E+12,200,2062,27.6,7475,2062,1,5413,7475
1.00E+12,310,129,2.8,4580,129,1,4451,4580
1.00E+12,310,65,2.9,2280,1174,18,39866,41040
1.00E+12,310,195,2.8,6950,195,1,6755,6950
1.00E+12,310,61,2.8,2180,61,1,2119,2180
8797938,310,55,2.8,1980,55,1,1925,1980
9069294,310,418,7,5980,418,1,5562,5980
1.00E+12,511,5437,54.9,9900,10874,2,8926,19800
6610869,310,270,9.8,2750,270,1,2480,2750
1.00E+12,310,1220,9.8,12400,1220,1,11180,12400
1.00E+12,310,430,9.8,4380,430,1,3950,4380
1.00E+12,200,14425,29.4,49000,14425,1,34575,49000
1.00E+12,200,745,10,7450,2980,4,26820,29800
2.10E+12,310,599,5,11980,599,1,11381,11980
1.00E+12,200,1106,20.9,5300,1106,1,4194,5300
1.00E+12,100,770,14,5500,3080,4,18920,22000
1.00E+12,100,448,14,3200,448,1,2752,3200
1.00E+12,200,4165,20.9,19900,4165,1,15735,19900
1.00E+12,100,2464,20.9,11800,2464,1,9336,11800
1.00E+12,200,934,13.5,6900,934,1,5966,6900
1.00E+12,100,1951,13.5,14400,1951,1,12449,14400
1.00E+12,205,9518,38.4,24800,9518,1,15282,24800
8379065,310,117,7,1680,117,1,1563,1680
2.10E+12,310,418,7,5980,418,1,5562,5980
2.10E+12,310,929,7.9,11800,929,1,10871,11800
1.00E+12,200,49800,20,249000,49800,1,199200,249000
1.00E+12,200,980,20,4900,2940,3,11760,14700
1.00E+12,310,6008,28.7,20900,6008,1,14892,20900
1.00E+12,205,6008,28.7,20900,6008,1,14892,20900
1.00E+12,310,1273,7.5,16900,1273,1,15627,16900
1.00E+12,310,1227,12.4,9900,1227,1,8673,9900
1.00E+12,310,412,7.5,5480,412,1,5068,5480
6615596,310,567,12.4,4580,567,1,4013,4580
1.00E+12,100,450,7.5,5980,450,1,5530,5980
1.00E+12,100,2835,16.8,16900,2835,1,14065,16900
1.00E+12,200,2835,16.8,16900,2835,1,14065,16900
1.00E+12,200,1980,16.8,11800,1980,1,9820,11800
1.00E+12,100,676,7.5,8980,676,1,8304,8980
1.00E+12,100,412,7.5,5480,412,1,5068,5480
1.00E+12,100,1723,12.4,13900,1723,1,12177,13900
1.00E+12,100,345,7.5,4580,345,1,4235,4580
1.00E+12,100,160,1,16000,160,1,15840,16000
1.00E+12,501,150,1,15000,300,2,29700,30000
1.00E+12,310,677,6.8,9980,677,1,9303,9980
1.00E+12,310,372,6.8,5480,372,1,5108,5480
1.00E+12,200,434,7,6200,868,2,11532,12400
1.00E+12,310,312,9.2,3380,312,1,3068,3380
1.00E+12,310,914,9.3,9880,914,1,8966,9880
2.10E+12,310,368,9.2,3980,368,1,3612,3980
1.00E+12,310,515,9.4,5480,515,1,4965,5480
7628565,310,718,19,3780,718,1,3062,3780
2.10E+12,310,1012,14.5,6980,1012,1,5968,6980
2.10E+12,310,838,14.5,5780,838,1,4942,5780
7022266,310,376,19,1980,376,1,1604,1980
1.00E+12,240,700,20,3500,1400,2,5600,7000
2.10E+12,310,3734,34.9,10700,3734,1,6966,10700
2.10E+12,205,865,25.6,3380,865,1,2515,3380
1.00E+12,310,57,3.8,1500,283,5,7217,7500
1.00E+12,310,180,3.8,4780,180,1,4600,4780
1.00E+12,310,373,3.8,9900,373,1,9527,9900
7580677,310,165,3.8,4380,165,1,4215,4380
2.10E+12,310,3859,36.1,10700,3859,1,6841,10700
1.00E+12,310,312,8.7,3600,312,1,3288,3600
1.00E+12,310,2597,36.1,7200,20778,8,36822,57600
1.00E+12,310,10112,25.6,39500,10112,1,29388,39500
1.00E+12,100,14248,17,83900,14248,1,69652,83900
1.00E+12,100,6186,20.6,30000,6186,1,23814,30000
7159274,310,830,10,8300,830,1,7470,8300
1.00E+12,200,11899,16.3,73000,11899,1,61101,73000
1.00E+12,300,11899,16.3,73000,11899,1,61101,73000
2.10E+12,310,5876,11.8,49800,5876,1,43924,49800
7469562,100,941,11.8,7980,941,1,7039,7980
1.00E+12,310,177,7.1,2480,177,1,2303,2480
1.00E+12,310,934,7.3,12800,934,1,11866,12800
1.00E+12,310,84,7.1,1180,84,1,1096,1180
1.00E+12,310,263,7.1,3680,263,1,3417,3680
6614078,340,189,6.3,3000,189,1,2811,3000
1.00E+12,310,1364,55,2480,5456,4,4464,9920
1.00E+12,310,481,8,5980,481,1,5499,5980
1.00E+12,310,418,8,5200,418,1,4782,5200
1.00E+12,240,1743,41.5,4200,3486,2,4914,8400
1.00E+12,310,1290,10,12900,1290,1,11610,12900
1.00E+12,310,1743,41.5,4200,3486,2,4914,8400
1.00E+12,310,74,5,1480,74,1,1406,1480
1.00E+12,511,1960,40,4900,5880,3,8820,14700
1.00E+12,240,314,7.2,4380,314,1,4066,4380
1.00E+12,205,100000,33.4,299000,100000,1,199000,299000
1.00E+12,310,349,5,6980,349,1,6631,6980
1.00E+12,310,152,7,2180,152,1,2028,2180
1.00E+12,310,170,10,1700,170,1,1530,1700
2.10E+12,205,1835,30.7,5980,1835,1,4145,5980
2.10E+12,100,520,10.9,4780,520,1,4260,4780
1.00E+12,601,49,5,980,196,4,3724,3920
1.00E+12,200,3780,2,189000,3780,1,185220,189000
8109093,310,97,9.9,980,194,2,1766,1960
1.00E+12,310,216,9.9,2180,216,1,1964,2180
7022305,310,2298,44.2,5200,4596,2,5804,10400
8627773,310,324,9.1,3580,324,1,3256,3580
8632626,310,841,9.4,8980,841,1,8139,8980
10008971,310,279,9.4,2980,558,2,5402,5960
1.00E+12,310,1122,9.4,11980,1122,1,10858,11980
1.00E+12,310,1783,9.4,18980,1783,1,17197,18980
1.00E+12,310,395,9.9,3980,395,1,3585,3980
1.00E+12,100,389,3.9,9900,389,1,9511,9900
6610095,310,548,6.8,8050,1096,2,15004,16100
7150833,310,373,6.8,5480,373,1,5107,5480
1.00E+12,310,374,6.8,5500,374,1,5126,5500
1.00E+12,310,946,19,4980,946,1,4034,4980
8225929,310,680,9.7,6980,680,1,6300,6980
2.10E+12,310,563,9.7,5780,563,1,5217,5780
1.00E+12,310,722,14.5,4980,722,1,4258,4980
1.00E+12,100,722,14.5,4980,722,1,4258,4980
2.10E+12,100,329,9.7,3380,329,1,3051,3380
8075883,310,395,5,7900,395,1,7505,7900
2.10E+12,200,1794,24,7475,1794,1,5681,7475
1.00E+12,200,4258,12.6,33800,4258,1,29542,33800
1.00E+12,501,4258,12.6,33800,4258,1,29542,33800
7938693,511,4800,50,9600,9600,2,9600,19200
1.00E+12,240,798,10,7980,2394,3,21546,23940
6615162,100,9,0.9,980,18,2,1942,1960
1.00E+12,310,1030,10,10300,1030,1,9270,10300
1.00E+12,511,3625,50,7250,7250,2,7250,14500
1.00E+12,501,8971,20.9,43000,8971,1,34029,43000
7718857,310,75,6.9,1080,75,1,1005,1080
1.00E+12,310,2915,9.7,29900,5830,2,53970,59800
1.00E+12,340,1400,10,14000,1400,1,12600,14000
6612206,310,540,5,10800,540,1,10260,10800
2.10E+12,240,548,10,5480,1096,2,9864,10960
1.00E+12,601,142,14.5,980,142,1,838,980
1.00E+12,240,3580,20,17900,14320,4,57280,71600
7895133,310,165,7,2360,660,4,8780,9440
1.00E+12,310,1150,10,11500,1150,1,10350,11500
1.00E+12,310,1180,10,11800,1180,1,10620,11800
2.10E+12,310,149,5,2980,298,2,5662,5960
2.10E+12,310,1590,12.4,12800,3180,2,22420,25600
8040364,310,238,10,2380,3332,14,29988,33320
1.00E+12,310,238,10,2380,238,1,2142,2380
1.00E+12,100,998,10,9980,998,1,8982,9980
1.00E+12,100,314,5,6280,314,1,5966,6280
1.00E+12,310,490,14.5,3380,490,1,2890,3380
6609543,310,330,14.5,2280,330,1,1950,2280
1.00E+12,310,756,7,10800,4536,6,60264,64800
1.00E+12,310,523,7,7480,3661,7,48699,52360
1.00E+12,310,199,5,3980,796,4,15124,15920
1.00E+12,200,5930,20.4,29000,11860,2,46140,58000
1.00E+12,300,39570,26,152100,39570,1,112530,152100
1.00E+12,200,6350,16.3,39000,6350,1,32650,39000
1.00E+12,200,5700,16.3,35000,5700,1,29300,35000
1.00E+12,200,10440,20.9,49900,20880,2,78920,99800
1.00E+12,310,1645,5,32900,1645,1,31255,32900
1.00E+12,300,13100,16.3,80400,13100,1,67300,80400
1.00E+12,310,299,5,5980,598,2,11362,11960
1.00E+12,200,3673,16.4,22400,3673,1,18727,22400
1.00E+12,200,5250,15,35000,5250,1,29750,35000
1.00E+12,200,3240,20,16200,3240,1,12960,16200
7238370,310,1848,55,3360,7392,4,6048,13440
8626466,310,615,10,6150,5535,9,49815,55350
2.10E+12,310,588,10,5880,6468,11,58212,64680
1.00E+12,310,836,9.7,8580,836,1,7744,8580
1.00E+12,100,287,14.5,1980,287,1,1693,1980
1.00E+12,100,436,9.7,4480,436,1,4044,4480
1.00E+12,310,628,7,8980,3768,6,50112,53880
1.00E+12,310,190,10,1900,570,3,5130,5700
1.00E+12,310,199,5,3980,398,2,7562,7960
2.10E+12,310,498,10,4980,498,1,4482,4980
1.00E+12,310,32,10,320,7680,240,69120,76800
7936333,310,1438,20.6,6980,1438,1,5542,6980
7936333,240,1438,20.6,6980,1438,1,5542,6980
1.00E+12,100,268,11.8,2280,3216,12,24144,27360
8639214,310,94,7,1350,94,1,1256,1350
10365921,310,269,7,3850,538,2,7162,7700
8210508,310,1323,7,18900,1323,1,17577,18900
6610267,310,209,7,2990,2090,10,27810,29900
6615115,340,329,7,4700,658,2,8742,9400
10627394,340,292,7,4180,292,1,3888,4180
2.10E+12,340,567,16.3,3480,567,1,2913,3480
1.00E+12,200,152,5.8,2600,304,2,4896,5200
1.00E+12,200,336,8,4200,336,1,3864,4200
1.00E+12,200,392,8,4900,392,1,4508,4900
1.00E+12,310,387,16.3,2380,774,2,3986,4760
1.00E+12,310,68,6.9,980,68,1,912,980
1.00E+12,310,96,7,1380,96,1,1284,1380
1.00E+12,310,348,7,4980,348,1,4632,4980
1.00E+12,310,1450,14.5,10000,1450,1,8550,10000
1.00E+12,100,10286,37,27800,10286,1,17514,27800
1.00E+12,300,37544,20.8,180500,37544,1,142956,180500
1.00E+12,310,60,5,1200,120,2,2280,2400
2.10E+12,310,118,10,1180,118,1,1062,1180
1.00E+12,310,888,10,8880,1776,2,15984,17760
6609400,310,380,10,3800,760,2,6840,7600
1.00E+12,310,398,10,3980,3582,9,32238,35820
9658414,310,180,10,1800,360,2,3240,3600
1.00E+12,310,259,6.6,3900,259,1,3641,3900
7544803,310,264,6.6,3980,264,1,3716,3980
1.00E+12,310,79,6.6,1200,79,1,1121,1200
7049652,310,426,6.7,6400,426,1,5974,6400
6951675,310,351,6.6,5280,351,1,4929,5280
1.00E+12,310,998,10,9980,998,1,8982,9980
6609429,310,138,10,1380,966,7,8694,9660
1.00E+12,310,645,5,12900,645,1,12255,12900
2.10E+12,310,257,7,3680,771,3,10269,11040
1.00E+12,310,99,5,1980,14256,144,270864,285120
2.10E+12,310,199,5,3980,1791,9,34029,35820
1.00E+12,200,8000,10,80000,16000,2,144000,160000
1.00E+12,310,636,4.3,14900,636,1,14264,14900
1.00E+12,310,5777,9.1,63750,11553,2,115947,127500
10698740,100,768,9.1,8480,768,1,7712,8480
6820123,100,436,13.8,3150,436,1,2714,3150
1.00E+12,310,398,10,3980,796,2,7164,7960
7179860,310,189,10,1890,378,2,3402,3780
1.00E+12,310,1218,6.8,17900,1218,1,16682,17900
6609038,310,158,8.8,1800,316,2,3284,3600
1.00E+12,310,218,8.8,2480,218,1,2262,2480
2.10E+12,310,1478,28,5280,25126,17,64634,89760
2.10E+12,310,298,10,2980,9238,31,83142,92380
2.10E+12,310,1850,10,18500,24050,13,216450,240500
7695459,310,470,10,4700,1410,3,12690,14100
1.00E+12,310,248,10,2480,1240,5,11160,12400
1.00E+12,310,598,10,5980,1794,3,16146,17940
1.00E+12,310,158,10,1580,14220,90,127980,142200
1.00E+12,310,1150,10,11500,2300,2,20700,23000
10219983,310,39,9.8,398,3822,98,35182,39004
1.00E+12,310,98,10,980,1372,14,12348,13720
1.00E+12,100,495,5,9900,495,1,9405,9900
1.00E+12,310,929,9.8,9480,929,1,8551,9480
2.10E+12,310,164,9.8,1680,164,1,1516,1680
2.10E+12,310,2020,36.9,5480,2020,1,3460,5480
6615248,310,225,9.8,2300,899,4,8301,9200
2.10E+12,310,94,5,1880,1128,12,21432,22560
2.10E+12,310,730,33.5,2180,1460,2,2900,4360
1.00E+12,310,313,9,3480,313,1,3167,3480
1.00E+12,340,2000,14.3,13980,10000,5,59900,69900
1.00E+12,340,3000,10.7,27980,6000,2,49960,55960
1.00E+12,340,3000,15,19980,6000,2,33960,39960
6610887,310,628,10,6280,628,1,5652,6280
1.00E+12,100,1860,10,18600,1860,1,16740,18600
1.00E+12,310,848,10,8480,2544,3,22896,25440
1.00E+12,310,598,10,5980,1196,2,10764,11960
1.00E+12,200,1808,5.9,30400,1808,1,28592,30400
1.00E+12,200,598,10,5980,598,1,5382,5980
1.00E+12,200,4551,5.9,76500,4551,1,71949,76500
1.00E+12,511,304,36.6,830,41037,135,71013,112050
1.00E+12,310,3058,36.1,8480,3058,1,5422,8480
1.00E+12,310,2842,36,7900,2842,1,5058,7900
1.00E+12,100,288,10,2880,864,3,7776,8640
1.00E+12,100,8490,10,84900,8490,1,76410,84900
1.00E+12,200,4000,20,20000,44000,11,176000,220000
5201859,300,6670,14.5,46000,6670,1,39330,46000
8632112,310,1298,10,12980,1298,1,11682,12980
1.00E+12,310,998,10,9980,998,1,8982,9980
1.00E+12,310,998,10,9980,998,1,8982,9980
1.00E+12,240,4360,20,21800,4360,1,17440,21800
7242787,310,562,14.5,3880,1686,3,9954,11640
10219983,310,56,14.1,398,224,4,1368,1592
1.00E+12,310,1012,14.5,6980,2024,2,11936,13960
1.00E+12,100,1447,14.5,9980,1447,1,8533,9980
1.00E+12,100,699,19,3680,1398,2,5962,7360
1.00E+12,100,362,14.5,2500,362,1,2138,2500
10219983,100,56,14.1,398,224,4,1368,1592
1.00E+12,310,497,6.9,7220,994,2,13446,14440
1.00E+12,310,418,7,5980,2090,5,27810,29900
7695362,310,217,7,3100,217,1,2883,3100
2.10E+12,310,2052,34.9,5880,16416,8,30624,47040
7021185,310,159,7,2280,795,5,10605,11400
1.00E+12,240,800,7.6,10500,3200,4,38800,42000
9653425,310,423,9.2,4580,423,1,4157,4580
1.00E+12,310,174,9.3,1880,2612,15,25588,28200
1.00E+12,310,958,9.2,10380,958,1,9422,10380
10041285,310,441,9.2,4780,441,1,4339,4780
1.00E+12,200,2400,8,30000,2400,1,27600,30000
1.00E+12,310,341,7,4880,341,1,4539,4880
1.00E+12,310,173,7,2480,173,1,2307,2480
2.10E+12,310,616,7,8800,616,1,8184,8800
1.00E+12,310,10000,7.2,139000,10000,1,129000,139000
1.00E+12,200,3950,10,39500,3950,1,35550,39500
1.00E+12,340,1953,24.5,7980,1953,1,6027,7980
1.00E+12,340,397,7,5680,397,1,5283,5680
1.00E+12,340,838,7,11980,838,1,11142,11980
9526026,340,348,7,4980,348,1,4632,4980
1.00E+12,310,7420,28,26500,200340,27,515160,715500
1.00E+12,200,5800,10,58000,5800,1,52200,58000
1.00E+12,200,5500,10,55000,5500,1,49500,55000
1.00E+12,200,5800,10,58000,5800,1,52200,58000
1.00E+12,200,1666,7,23800,1666,1,22134,23800
1.00E+12,500,10000,8,125000,10000,1,115000,125000
1.00E+12,310,468,10,4680,15444,33,138996,154440
1.00E+12,310,360,10,3600,720,2,6480,7200
6972035,310,149,5,2980,745,5,14155,14900
8082162,310,349,5,6980,6631,19,125989,132620
7150833,310,249,5,4990,5976,24,113784,119760
1.00E+12,310,99,5,1980,990,10,18810,19800
1.00E+12,511,2883,37.9,7600,8650,3,14150,22800
1.00E+12,340,330,6.9,4780,330,1,4450,4780
1.00E+12,310,293,5.3,5480,293,1,5187,5480
1.00E+12,310,53,5.4,980,105,2,1855,1960
1.00E+12,310,288,5.4,5380,288,1,5092,5380
1.00E+12,310,64,5.3,1200,128,2,2272,2400
8553755,310,188,5.4,3500,375,2,6625,7000
1.00E+12,200,6452,24.3,26500,6452,1,20048,26500
8228112,310,2370,53.5,4430,14220,6,12360,26580
6610189,310,65,6.9,940,1105,17,14875,15980
1.00E+12,310,201,7,2880,201,1,2679,2880
1.00E+12,310,698,10,6980,698,1,6282,6980
8077493,310,215,10,2150,1505,7,13545,15050
8843453,310,642,7,9180,642,1,8538,9180
1.00E+12,310,486,7,6950,2916,6,38784,41700
1.00E+12,310,616,7,8800,1232,2,16368,17600
7910514,310,763,7,10900,3815,5,50685,54500
1.00E+12,310,138,7,1980,552,4,7368,7920
7081031,310,77,7,1100,924,12,12276,13200
2.10E+12,310,266,7,3800,266,1,3534,3800
1.00E+12,310,30,7,430,15000,500,200000,215000
1.00E+12,100,1658,15.2,10900,3316,2,18484,21800
1.00E+12,500,1658,15.2,10900,3316,2,18484,21800
1.00E+12,310,1980,10,19800,1980,1,17820,19800
8431447,501,152,7,2180,152,1,2028,2180
2.10E+12,501,1389,26.3,5280,1389,1,3891,5280
1.00E+12,240,248,10,2480,7440,30,66960,74400
2.10E+12,200,1000,9.3,10800,1000,1,9800,10800
7021920,310,68,6.9,980,2992,44,40128,43120
2.10E+12,200,3456,25.6,13500,3456,1,10044,13500
8583164,310,693,7,9900,2772,4,36828,39600
1.00E+12,200,3900,10,39000,3900,1,35100,39000
1.00E+12,310,1150,10,11500,1150,1,10350,11500
1.00E+12,310,1303,8.4,15500,1303,1,14197,15500
1.00E+12,310,33,8.3,398,66,2,730,796
6610289,310,3530,8.4,41900,3530,1,38370,41900
1.00E+12,310,84,5,1680,756,9,14364,15120
1.00E+12,310,249,5,4980,7470,30,141930,149400
1.00E+12,310,199,5,3980,796,4,15124,15920
1.00E+12,200,2850,15,19000,5700,2,32300,38000
1.00E+12,310,4281,23.9,17900,17122,4,54478,71600
2.10E+12,200,993,14.4,6900,1986,2,11814,13800
1.00E+12,310,94,5,1880,1034,11,19646,20680
8116426,310,109,5,2180,109,1,2071,2180
,,,,,,,,
1.00E+12,300,6460,19,34000,19380,3,82620,102000
1.00E+12,310,68,6.9,980,680,10,9120,9800
1.00E+12,310,1214,7.4,16480,1214,1,15266,16480
8781553,310,625,7.4,8480,625,1,7855,8480
,,,,,,,,
,,,,,,,,
1.00E+12,200,12300,15,82000,110700,9,627300,738000
2.10E+12,200,1000,12.5,7980,7000,7,48860,55860
2.10E+12,200,2370,20,11850,94800,40,379200,474000
1.00E+12,240,500,4.6,10780,2500,5,51400,53900
1.00E+12,310,881,8.9,9950,881,1,9069,9950
6610189,100,82,8.7,940,82,1,858,940
1.00E+12,100,139,8.8,1580,139,1,1441,1580
7695649,100,86,8.7,990,86,1,904,990
1.00E+12,100,112,8.8,1280,224,2,2336,2560
1.00E+12,100,86,8.8,980,86,1,894,980
1.00E+12,100,378,8.8,4280,378,1,3902,4280
1.00E+12,310,219,5,4380,219,1,4161,4380
1.00E+12,200,37710,25.3,149000,75420,2,222580,298000
8117928,100,99,2,4980,99,1,4881,4980
1.00E+12,310,6720,24,28000,6720,1,21280,28000
1.00E+12,200,2800,5,56000,5600,2,106400,112000
1.00E+12,310,765,6.5,11800,765,1,11035,11800
10698740,310,549,6.5,8480,549,1,7931,8480
6864891,310,226,6.5,3480,451,2,6509,6960
1.00E+12,310,128,6.5,1980,128,1,1852,1980
1.00E+12,511,313,37.7,830,5625,18,9315,14940
1.00E+12,500,8420,17.5,48000,16840,2,79160,96000
2.10E+12,310,278,7,3980,278,1,3702,3980
8038545,310,138,7,1980,138,1,1842,1980
7901414,310,198,10,1980,1584,8,14256,15840
1.00E+12,200,1500,15,10000,4500,3,25500,30000
1.00E+12,310,137,3.9,3500,137,1,3363,3500
1.00E+12,310,216,3.9,5500,216,1,5284,5500
1.00E+12,310,117,3.9,2980,936,8,22904,23840
6621714,310,274,3.9,6980,274,1,6706,6980
8040490,310,136,3.9,3480,136,1,3344,3480
1.00E+12,200,5322,23.1,23000,5322,1,17678,23000
1.00E+12,310,565,14.5,3900,565,1,3335,3900
2.10E+12,310,1080,10,10800,5400,5,48600,54000
8114120,601,609,14.5,4200,609,1,3591,4200
1.00E+12,601,565,14.5,3900,565,1,3335,3900
1.00E+12,340,390,7,5580,390,1,5190,5580
1.00E+12,200,6930,19.3,36000,6930,1,29070,36000
2.10E+12,205,654,30,2180,3924,6,9156,13080
2.10E+12,310,231,9,2580,231,1,2349,2580
2.10E+12,310,537,9,5980,537,1,5443,5980
7175432,310,323,9,3600,323,1,3277,3600
2.10E+12,200,3222,27.2,11850,3222,1,8628,11850
2.10E+12,200,8160,40.8,19980,8160,1,11820,19980
1.00E+12,200,12810,22.1,58000,12810,1,45190,58000
1.00E+12,200,4025,12.6,32000,4025,1,27975,32000
1.00E+12,310,258,10,2580,516,2,4644,5160
1.00E+12,200,10500,15,70000,199500,19,1130500,1330000
1.00E+12,200,712,8,8900,712,1,8188,8900
1.00E+12,310,332,40,830,155365,468,233075,388440
1.00E+12,500,596,2,29800,1788,3,87612,89400
8594928,310,195,10,1950,3120,16,28080,31200
6610205,310,125,10,1250,2000,16,18000,20000
1.00E+12,240,154,7.8,1980,462,3,5478,5940
7895133,310,236,10,2360,2360,10,21240,23600
1.00E+12,310,288,10,2880,288,1,2592,2880
1.00E+12,310,5049,18.8,26900,15147,3,65553,80700
1.00E+12,500,2516,13.6,18500,5032,2,31968,37000
1.00E+12,300,2480,10,24800,2480,1,22320,24800
1.00E+12,200,880,5,17600,1760,2,33440,35200
1.00E+12,200,2430,20.3,12000,7290,3,28710,36000
1.00E+12,200,2060,5,41300,2060,1,39240,41300
4914527,200,6540,6,109000,6540,1,102460,109000
1.00E+12,205,4320,30,14400,21600,5,50400,72000
1.00E+12,200,1990,10,19900,1990,1,17910,19900
1.00E+12,310,62,7,890,558,9,7452,8010
1.00E+12,310,71,7,1020,1846,26,24674,26520
1.00E+12,310,84,7,1200,588,7,7812,8400
2.10E+12,200,990,10,9900,2970,3,26730,29700
1.00E+12,310,49,5,980,735,15,13965,14700
1.00E+12,310,149,5,2980,298,2,5662,5960
7452329,310,214,5,4280,2140,10,40660,42800
9707917,310,149,5,2980,596,4,11324,11920
2.10E+12,100,1909,16.6,11480,1909,1,9571,11480
2.10E+12,100,59,2,2980,59,1,2921,2980
1.00E+12,501,0,0,3880,0,1,3880,3880
1.00E+12,310,87,9.8,890,174,2,1606,1780
6890809,310,635,9.8,6480,635,1,5845,6480
1.00E+12,310,1058,9.8,10800,1058,1,9742,10800
1.00E+12,200,2030,8.9,22900,4060,2,41740,45800
,,,,,,,,
1.00E+12,511,633,33.3,1900,13300,21,26600,39900
1.00E+12,310,418,7,5980,1254,3,16686,17940
1.00E+12,310,558,7,7980,558,1,7422,7980
9656160,310,201,7,2880,603,3,8037,8640
1.00E+12,205,11040,46,24000,11040,1,12960,24000
1.00E+12,100,1330,19,7000,1330,1,5670,7000
6615474,100,486,19,2560,2430,5,10370,12800
1.00E+12,310,209,5,4180,1672,8,31768,33440
1.00E+12,240,700,20,3500,2100,3,8400,10500
2.10E+12,310,418,7,5980,1254,3,16686,17940
7241898,310,424,5,8480,424,1,8056,8480
1.00E+12,200,7220,18.5,39000,7220,1,31780,39000
1.00E+12,340,558,7,7980,5580,10,74220,79800
6616190,310,398,10,3980,1592,4,14328,15920
1.00E+12,310,2375,19,12500,2375,1,10125,12500
8227112,310,35,10,350,245,7,2205,2450
1.00E+12,205,2375,19,12500,2375,1,10125,12500
1.00E+12,310,175,7,2500,525,3,6975,7500
2.10E+12,310,89,7,1280,801,9,10719,11520
1.00E+12,340,735,7,10500,735,1,9765,10500
1.00E+12,205,2100,23.4,8980,23100,11,75680,98780
2.10E+12,310,379,7.6,4980,379,1,4601,4980
2.10E+12,310,89,7.5,1180,178,2,2182,2360
2.10E+12,310,3753,29.1,12900,3753,1,9147,12900
2.10E+12,310,830,7.6,10900,830,1,10070,10900
2.10E+12,200,3753,29.1,12900,3753,1,9147,12900
1.00E+12,100,12564,46.2,27200,50256,4,58544,108800
1.00E+12,205,12564,46.2,27200,50256,4,58544,108800
1.00E+12,310,444,5,8880,444,1,8436,8880
1.00E+12,310,735,7,10500,1470,2,19530,21000
1.00E+12,310,82,6.9,1180,328,4,4392,4720
7934427,310,451,9.8,4580,451,1,4129,4580
8503364,310,1379,9.9,13980,1379,1,12601,13980
2.10E+12,200,7384,37,19980,7384,1,12596,19980
2.10E+12,205,555,3,18500,2775,5,89725,92500
1.00E+12,310,798,10,7980,798,1,7182,7980
1.00E+12,310,1890,10,18900,5670,3,51030,56700
1.00E+12,511,4140,55.3,7480,8279,2,6681,14960
1.00E+12,310,852,10.7,7980,852,1,7128,7980
8023235,310,104,10.6,980,208,2,1752,1960
1.00E+12,100,104,10.6,980,104,1,876,980
8615388,100,1811,10.7,16900,3622,2,30178,33800
1.00E+12,100,4140,55.3,7480,8279,2,6681,14960
8316420,501,524,10.7,4900,524,1,4376,4900
1.00E+12,501,457,10.7,4280,457,1,3823,4280
1.00E+12,501,745,10.7,6980,745,1,6235,6980
8615388,501,1811,10.7,16900,3622,2,30178,33800
1.00E+12,310,343,9.9,3450,343,1,3107,3450
2.10E+12,310,346,9.9,3480,346,1,3134,3480
1.00E+12,310,243,9.9,2450,243,1,2207,2450
1.00E+12,100,1229,14.5,8480,1229,1,7251,8480
1.00E+12,310,99,5,1990,297,3,5673,5970
1.00E+12,205,2910,30,9700,107670,37,251230,358900
1.00E+12,310,54,6.9,780,648,12,8712,9360
1.00E+12,310,593,7,8480,2965,5,39435,42400
7902558,310,124,7,1780,248,2,3312,3560
1.00E+12,310,1065,9.9,10780,2129,2,19431,21560
1.00E+12,310,201,7,2880,402,2,5358,5760
1.00E+12,310,268,7,3840,804,3,10716,11520
6615745,310,348,7,4980,348,1,4632,4980
8882973,310,948,10,9480,12324,13,110916,123240
1.00E+12,310,733,7,10480,1466,2,19494,20960
1.00E+12,310,418,7,5980,2090,5,27810,29900
2.10E+12,310,336,7,4800,336,1,4464,4800
1.00E+12,310,3842,51.4,7480,7683,2,7277,14960
7354940,310,40,2.7,1480,40,1,1440,1480
2.10E+12,310,1253,7,17900,10024,8,133176,143200
1.00E+12,310,327,7,4680,5886,18,78354,84240
1.00E+12,310,192,5,3840,192,1,3648,3840
7049663,310,362,7,5180,1810,5,24090,25900
1.00E+12,205,5400,41.3,13080,10800,2,15360,26160
1.00E+12,100,2230,11.8,18900,2230,1,16670,18900
1.00E+12,100,1842,5.9,31145,1842,1,29303,31145
1.00E+12,501,1842,5.9,31145,1842,1,29303,31145
1.00E+12,310,3723,10.7,34800,3723,1,31077,34800
2.10E+12,310,500,10,5000,29500,59,265500,295000
1.00E+12,310,349,5,6980,349,1,6631,6980
1.00E+12,310,347,5,6950,347,1,6603,6950
1.00E+12,310,149,5,2980,298,2,5662,5960
2.10E+12,310,849,5,16980,3396,4,64524,67920
8333576,100,36,1,3650,36,1,3614,3650
1.00E+12,501,119,1,11900,119,1,11781,11900
1.00E+12,310,131,7,1880,262,2,3498,3760
1.00E+12,310,173,7,2480,173,1,2307,2480
1.00E+12,310,124,7,1780,1984,16,26496,28480
1.00E+12,310,222,7,3180,666,3,8874,9540
1.00E+12,310,498,10,4980,1992,4,17928,19920
2.10E+12,310,80,10,800,160,2,1440,1600
1.00E+12,310,44,5,880,2112,48,40128,42240
1.00E+12,310,244,10,2440,732,3,6588,7320
8609842,511,432,40,1080,11664,27,17496,29160
1.00E+12,205,2794,28,9980,5588,2,14372,19960
1.00E+12,310,798,10,7980,798,1,7182,7980
6593386,200,6720,7,96000,13440,2,178560,192000
1.00E+12,200,2590,19.2,13500,54390,21,229110,283500
2.10E+12,310,950,19,5000,15200,16,64800,80000
1.00E+12,310,498,10,4980,1992,4,17928,19920
6615248,310,230,10,2300,11730,51,105570,117300
2.10E+12,200,2090,19,11000,2090,1,8910,11000
2.10E+12,200,950,19,5000,11400,12,48600,60000
1.00E+12,310,199,5,3980,2388,12,45372,47760
1.00E+12,310,621,7,8880,7452,12,99108,106560
1.00E+12,310,96,7,1380,2016,21,26964,28980
1.00E+12,310,24416,28,87200,24416,1,62784,87200
9675054,310,285,10,2850,2280,8,20520,22800
7548645,310,298,10,2980,596,2,5364,5960
1.00E+12,310,349,5,6980,698,2,13262,13960
8093106,511,3328,55,6050,19965,6,16335,36300
1.00E+12,200,1720,8,21500,3440,2,39560,43000
1.00E+12,310,298,10,2980,1788,6,16092,17880
2.10E+12,310,1480,10,14800,4440,3,39960,44400
1.00E+12,200,1490,5.5,26900,2980,2,50820,53800
1.00E+12,200,16790,4.9,340000,33580,2,646420,680000
1.00E+12,310,1452,7.3,19900,1452,1,18448,19900
6610267,310,218,7.3,2990,218,1,2772,2990
1.00E+12,240,1340,50,2680,158120,118,158120,316240
1.00E+12,310,109,5,2180,763,7,14497,15260
7150448,310,40,6.9,580,40,1,540,580
2.10E+12,310,278,7,3980,4170,15,55530,59700
1.00E+12,310,1190,10,11900,1190,1,10710,11900
1.00E+12,310,168,10,1680,672,4,6048,6720
8333411,310,95,10,950,2185,23,19665,21850
1.00E+12,310,368,10,3680,736,2,6624,7360
2.10E+12,310,880,10,8800,3520,4,31680,35200
6615110,310,298,10,2980,3576,12,32184,35760
1.00E+12,200,2780,20,13900,33360,12,133440,166800
1.00E+12,100,1244,14.5,8580,2488,2,14672,17160
2.10E+12,100,184,13.3,1380,184,1,1196,1380
1.00E+12,100,2475,17.9,13800,4950,2,22650,27600
7928923,310,118,7,1680,236,2,3124,3360
2.10E+12,310,1766,25.6,6900,3532,2,10268,13800
1.00E+12,511,722,38,1900,2166,3,3534,5700
1.00E+12,500,0,0,28800,0,6,172800,172800
1.00E+12,310,693,7,9900,4851,7,64449,69300
7632909,310,180,5,3600,360,2,6840,7200
1.00E+12,310,149,5,2980,298,2,5662,5960
1.00E+12,310,216,5,4320,216,1,4104,4320
1.00E+12,100,1207,14.1,8580,1207,1,7373,8580
2.10E+12,310,139,5,2780,1112,8,21128,22240
8279126,310,114,5,2280,1254,11,23826,25080
1.00E+12,200,11480,20,57400,11480,1,45920,57400
1.00E+12,310,249,5,4980,996,4,18924,19920
2.10E+12,310,3008,33.5,8980,3008,1,5972,8980
1.00E+12,310,3610,19,19000,10830,3,46170,57000
1.00E+12,200,3610,19,19000,10830,3,46170,57000
1.00E+12,310,651,10.9,5980,1302,2,10658,11960
1.00E+12,310,54,10.8,500,162,3,1338,1500
1.00E+12,310,76,10.9,700,152,2,1248,1400
2.10E+12,200,8407,42.1,19980,8407,1,11573,19980
1.00E+12,100,76,10.9,700,152,2,1248,1400
1.00E+12,501,148,10,1480,592,4,5328,5920
1.00E+12,501,501,10.9,4600,501,1,4099,4600
8650625,501,158,10,1580,158,1,1422,1580
1.00E+12,100,6680,16.7,40000,6680,1,33320,40000
1.00E+12,200,6680,16.7,40000,6680,1,33320,40000
1.00E+12,100,3217,9.7,33000,6434,2,59566,66000
1.00E+12,310,245,9.9,2480,245,1,2235,2480
1.00E+12,310,116,9.8,1180,116,1,1064,1180
1.00E+12,200,1310,4,32900,1310,1,31590,32900
10732911,240,98,10,980,4116,42,37044,41160
1.00E+12,200,3900,10,39000,3900,1,35100,39000
1.00E+12,240,596,20,2980,596,1,2384,2980
6609236,310,117,7,1680,585,5,7815,8400
1.00E+12,310,271,7,3880,2439,9,32481,34920
1.00E+12,200,1824,4,45600,1824,1,43776,45600
7134845,310,271,7,3880,1626,6,21654,23280
1.00E+12,200,9720,15,64800,9720,1,55080,64800
1.00E+12,310,861,7,12300,861,1,11439,12300
1.00E+12,310,1418,16.3,8700,1418,1,7282,8700
7354825,310,998,10,9980,4990,5,44910,49900
7179228,310,150,10,1500,1500,10,13500,15000
1.00E+12,500,6720,22.4,30000,20160,3,69840,90000
8038256,310,150,7.6,1980,150,1,1830,1980
1.00E+12,100,10776,24,44900,10776,1,34124,44900
8023182,310,280,7,4000,840,3,11160,12000
8333662,240,585,19,3080,4680,8,19960,24640
8333648,240,642,19,3380,7704,12,32856,40560
1.00E+12,310,238,10,2380,3570,15,32130,35700
1.00E+12,501,15805,14.5,109000,15805,1,93195,109000
2.10E+12,200,1272,15,8480,1272,1,7208,8480
10220721,310,628,10,6280,628,1,5652,6280
1.00E+12,500,990,5,19800,11880,12,225720,237600
2.10E+12,310,411,7,5880,822,2,10938,11760
6612293,100,519,14.5,3580,519,1,3061,3580
1.00E+12,310,201,7,2880,2010,10,26790,28800
1.00E+12,310,1085,7,15500,2170,2,28830,31000
9063930,310,453,7,6480,453,1,6027,6480
8068925,310,558,7,7980,5022,9,66798,71820
1.00E+12,310,1013,7,14480,4052,4,53868,57920
1.00E+12,205,1137,16.3,6980,20466,18,105174,125640
8365726,310,230,10,2300,230,1,2070,2300
2.10E+12,310,1421,19,7480,1421,1,6059,7480
6834866,601,78,5,1560,78,1,1482,1560
2.10E+12,310,279,5,5580,1674,6,31806,33480
1.00E+12,310,1567,8.8,17820,1567,1,16253,17820
1.00E+12,240,1014,9.4,10780,1014,1,9766,10780
2.10E+12,340,1036,7,14800,1036,1,13764,14800
1.00E+12,340,803,7,11480,803,1,10677,11480
1.00E+12,511,4002,53.5,7480,8003,2,6957,14960
1.00E+12,310,54,6.9,780,162,3,2178,2340
1.00E+12,310,349,7.8,4500,349,1,4151,4500
1.00E+12,310,237,7.8,3050,473,2,5627,6100
2.10E+12,205,414,28,1480,414,1,1066,1480
1.00E+12,310,328,39.5,830,5907,18,9033,14940
1.00E+12,310,7273,27.4,26500,7273,1,19227,26500
1.00E+12,310,357,9,3980,357,1,3623,3980
1.00E+12,310,267,9,2980,267,1,2713,2980
1.00E+12,200,1805,18.1,9980,1805,1,8175,9980
8210501,310,1568,9.3,16900,1568,1,15332,16900
1.00E+12,310,918,9.3,9900,918,1,8982,9900
1.00E+12,200,16500,15,110000,33000,2,187000,220000
7331560,310,222,7,3180,666,3,8874,9540
1.00E+12,310,268,7,3840,1876,7,25004,26880
1.00E+12,310,488,7,6980,1952,4,25968,27920
1.00E+12,310,5451,15.4,35400,10902,2,59898,70800
1.00E+12,200,5451,15.4,35400,10902,2,59898,70800
1.00E+12,300,9625,31.1,30900,279125,29,616975,896100
1.00E+12,200,5761,20.9,27500,5761,1,21739,27500
1.00E+12,500,17793,23.3,76300,17793,1,58507,76300
1.00E+12,200,1755,17.6,10000,1755,1,8245,10000
1.00E+12,310,1890,18.9,9980,1890,1,8090,9980
1.00E+12,310,692,9.9,6980,692,1,6288,6980
1.00E+12,310,325,9.9,3280,325,1,2955,3280
1.00E+12,200,11407,17.5,65000,22814,2,107186,130000
1.00E+12,500,11407,17.5,65000,22814,2,107186,130000
7047985,340,190,6.4,2980,190,1,2790,2980
1.00E+12,100,7500,5,150000,7500,1,142500,150000
1.00E+12,310,1978,18.3,10780,3956,2,17604,21560
1.00E+12,511,759,40,1900,2278,3,3422,5700
2.10E+12,200,1272,15,8480,10176,8,57664,67840
8961033,240,100,2.5,3980,1000,10,38800,39800
1.00E+12,200,6669,17.6,38000,6669,1,31331,38000
1.00E+12,200,9025,25.8,35000,9025,1,25975,35000
1.00E+12,300,9025,25.8,35000,9025,1,25975,35000
1.00E+12,500,9025,25.8,35000,9025,1,25975,35000
2.10E+12,200,3316,15.9,20800,3316,1,17484,20800
1.00E+12,310,198,10,1980,396,2,3564,3960
7544803,240,334,8.4,3980,667,2,7293,7960
1.00E+12,310,299,5,5980,598,2,11362,11960
1.00E+12,310,214,5,4280,428,2,8132,8560
2.10E+12,310,2540,19.8,12800,10160,4,41040,51200
1.00E+12,310,49,5,980,1617,33,30723,32340
9593811,310,298,10,2980,894,3,8046,8940
6845372,310,498,10,4980,996,2,8964,9960
1.00E+12,310,798,10,7980,2394,3,21546,23940
1.00E+12,310,548,10,5480,8768,16,78912,87680
2.10E+12,200,348,10,3480,27840,80,250560,278400
1.00E+12,300,14065,14.5,97000,14065,1,82935,97000
1.00E+12,310,9911,24.9,39800,9911,1,29889,39800
1.00E+12,200,9911,24.9,39800,9911,1,29889,39800
1.00E+12,200,4830,21,23000,4830,1,18170,23000
1.00E+12,310,299,5,5980,299,1,5681,5980
1.00E+12,310,1080,10,10800,3240,3,29160,32400
1.00E+12,240,819,18.7,4380,819,1,3561,4380
2.10E+12,310,862,8,10800,862,1,9938,10800
2.10E+12,200,598,17.2,3480,598,1,2882,3480
2.10E+12,200,2702,25,10800,2702,1,8098,10800
1.00E+12,310,9863,27.4,36000,9863,1,26137,36000
1.00E+12,310,8545,27.4,31200,8545,1,22655,31200
1.00E+12,200,3754,18.3,20500,3754,1,16746,20500
1.00E+12,200,5347,22.9,23400,5347,1,18053,23400
2.10E+12,200,1680,14.6,11480,21840,13,127400,149240
1.00E+12,310,1118,7,15980,2236,2,29724,31960
1.00E+12,200,1197,3,39900,1197,1,38703,39900
1.00E+12,310,258,10,2580,1032,4,9288,10320
1.00E+12,310,343,10,3430,1029,3,9261,10290
2.10E+12,310,2090,19,11000,2090,1,8910,11000
1.00E+12,310,2458,37.4,6580,2458,1,4122,6580
2.10E+12,310,5560,35.2,15800,5560,1,10240,15800
8797938,310,322,16.3,1980,322,1,1658,1980
1.00E+12,205,2376,24,9900,2376,1,7524,9900
1.00E+12,310,309,3.1,9880,309,1,9571,9880
1.00E+12,310,312,3.1,9980,312,1,9668,9980
1.00E+12,310,280,3.1,8980,280,1,8700,8980
1.00E+12,310,280,3.1,8980,280,1,8700,8980
1.00E+12,310,250,3.1,7980,499,2,15461,15960
7501736,310,203,3.1,6500,203,1,6297,6500
1.00E+12,310,2443,7,34900,2443,1,32457,34900
1.00E+12,310,990,10,9900,7920,8,71280,79200
2.10E+12,310,3740,21,17800,18700,5,70300,89000
7332561,310,99,5,1980,198,2,3762,3960
1.00E+12,310,249,5,4980,249,1,4731,4980
2.10E+12,200,1470,15,9800,26460,18,149940,176400
1.00E+12,310,6914,15.4,44900,6914,1,37986,44900
2.10E+12,310,460,8.7,5300,460,1,4840,5300
1.00E+12,310,469,8.7,5400,469,1,4931,5400
7628565,100,38,1,3880,76,2,7684,7760
1.00E+12,340,616,7,8800,616,1,8184,8800
1.00E+12,310,149,5,2980,2235,15,42465,44700
1.00E+12,200,1100,10,11000,1100,1,9900,11000
2.10E+12,200,9461,23.2,40800,9461,1,31339,40800
2.10E+12,310,2349,12.7,18500,7047,3,48453,55500
6870258,310,298,10,2980,1192,4,10728,11920
2.10E+12,310,1150,10,11500,14950,13,134550,149500
1.00E+12,205,2725,25,10900,21800,8,65400,87200
1.00E+12,310,65,5,1300,65,1,1235,1300
1.00E+12,200,288,8,3600,576,2,6624,7200
1.00E+12,200,11000,10,110000,11000,1,99000,110000
1.00E+12,310,348,9.5,3680,696,2,6664,7360
1.00E+12,310,244,9.5,2580,488,2,4672,5160
2.10E+12,310,298,10,2980,6854,23,61686,68540
1.00E+12,310,1580,10,15800,36340,23,327060,363400
1.00E+12,240,485,16.3,2980,5820,12,29940,35760
2.10E+12,205,796,20,3980,6368,8,25472,31840
1.00E+12,200,7125,9.9,71900,7125,1,64775,71900
1.00E+12,310,1295,5,25900,1295,1,24605,25900
1.00E+12,310,197,5,3950,197,1,3753,3950
8333662,310,559,18.1,3080,559,1,2521,3080
1.00E+12,310,1170,10,11700,5850,5,52650,58500
1.00E+12,310,178,10,1780,890,5,8010,8900
2.10E+12,310,750,10,7500,750,1,6750,7500
1.00E+12,340,17185,11.5,150000,17185,1,132815,150000
1.00E+12,310,85,9.7,880,85,1,795,880
1.00E+12,310,288,9.7,2980,288,1,2692,2980
1.00E+12,310,774,9.7,7990,774,1,7216,7990
6609540,340,152,5.1,2980,152,1,2828,2980
7588534,340,51,5.1,1000,51,1,949,1000
1.00E+12,310,15980,20,79900,15980,1,63920,79900
1.00E+12,310,15980,20,79900,31960,2,127840,159800
1.00E+12,310,120,10,1200,360,3,3240,3600
1.00E+12,310,800,10,8000,3200,4,28800,32000
1.00E+12,340,246,6.8,3600,738,3,10062,10800
6616028,310,100,10,1000,4199,42,37801,42000
1.00E+12,310,598,10,5980,5382,9,48438,53820
1.00E+12,310,238,10,2380,238,1,2142,2380
7167925,310,108,10,1080,108,1,972,1080
6977207,310,124,7,1780,496,4,6624,7120
1.00E+12,310,231,7,3300,462,2,6138,6600
10732906,310,243,7,3480,1215,5,16185,17400
1.00E+12,200,1629,11.5,14200,1629,1,12571,14200
6610943,100,428,10,4280,428,1,3852,4280
1.00E+12,511,1790,50,3580,64440,36,64440,128880
1.00E+12,310,2580,20,12900,2580,1,10320,12900
2.10E+12,310,324,9.6,3380,324,1,3056,3380
2.10E+12,310,325,9.6,3380,649,2,6111,6760
9054179,310,382,9.6,3980,764,2,7196,7960
1.00E+12,310,228,9.6,2380,228,1,2152,2380
1.00E+12,310,229,5,4580,3893,17,73967,77860
1.00E+12,310,1440,5,28800,4320,3,82080,86400
1.00E+12,310,595,5,11900,3570,6,67830,71400
1.00E+12,310,299,5,5980,1196,4,22724,23920
1.00E+12,200,31080,24,129500,62160,2,196840,259000
2.10E+12,310,908,7,12980,2724,3,36216,38940
1.00E+12,200,41910,26,161100,41910,1,119190,161100
1.00E+12,300,41910,26,161100,41910,1,119190,161100
1.00E+12,300,31820,24.9,127800,31820,1,95980,127800
1.00E+12,500,31820,24.9,127800,31820,1,95980,127800
6609410,310,892,9,9900,892,1,9008,9900
1.00E+12,310,704,8.9,7900,704,1,7196,7900
7695687,310,186,9.4,1980,557,3,5383,5940
8456661,310,159,9.4,1700,159,1,1541,1700
1.00E+12,240,1464,13.6,10780,1464,1,9316,10780
1.00E+12,310,761,9.9,7680,761,1,6919,7680
8630103,310,2286,9.9,22980,2286,1,20694,22980
1.00E+12,310,74,5,1480,1332,18,25308,26640
1.00E+12,310,7960,14.5,54900,7960,1,46940,54900
1.00E+12,310,771,7.8,9900,771,1,9129,9900
1.00E+12,310,614,4.9,12580,614,1,11966,12580
1.00E+12,340,138,7,1980,138,1,1842,1980
8316421,310,648,10,6480,648,1,5832,6480
6614764,310,258,10,2580,3870,15,34830,38700
2.10E+12,200,1398,28.1,4980,4194,3,10746,14940
7904387,310,138,7,1980,1242,9,16578,17820
1.00E+12,310,252,7,3600,2520,10,33480,36000
8040272,310,213,7,3050,426,2,5674,6100
1.00E+12,310,140,7,2000,140,1,1860,2000
1.00E+12,200,1112,8,13900,1112,1,12788,13900
1.00E+12,200,274597,8.8,3120000,274597,1,2845403,3120000
1.00E+12,310,299,5,5980,2093,7,39767,41860
1.00E+12,310,122,5,2450,122,1,2328,2450
1.00E+12,310,56,7,800,4592,82,61008,65600
2.10E+12,310,411,7,5880,3699,9,49221,52920
2.10E+12,310,138,7,1980,276,2,3684,3960
6610147,310,568,19.1,2980,3408,6,14472,17880
1.00E+12,310,1490,10,14900,1490,1,13410,14900
1.00E+12,240,2595,14.5,17900,5190,2,30610,35800
6621587,310,98,10,980,1470,15,13230,14700
1.00E+12,310,1534,28,5480,3068,2,7892,10960
8038256,310,198,10,1980,7722,39,69498,77220
1.00E+12,310,96,5,1920,288,3,5472,5760
1.00E+12,310,99,5,1980,198,2,3762,3960
1.00E+12,310,119,5,2380,119,1,2261,2380
1.00E+12,240,1084,14.5,7480,7588,7,44772,52360
1.00E+12,310,240,10,2400,480,2,4320,4800
1.00E+12,310,398,10,3980,796,2,7164,7960
1.00E+12,310,599,16.3,3680,4193,7,21567,25760
1.00E+12,200,2480,31,8000,2480,1,5520,8000
1.00E+12,200,2759,31,8900,2759,1,6141,8900
1.00E+12,200,415,5,8300,415,1,7885,8300
1.00E+12,310,495,5,9900,495,1,9405,9900
1.00E+12,310,44,4.9,890,1100,25,21150,22250
8040482,310,179,5,3580,358,2,6802,7160
7518252,310,154,7,2200,154,1,2046,2200
2.10E+12,310,4996,11.2,44800,19984,4,159216,179200
2.10E+12,310,298,10,2980,1490,5,13410,14900
1.00E+12,310,195,5,3900,1755,9,33345,35100
7609955,310,414,6.9,6000,414,1,5586,6000
2.10E+12,310,343,6.9,4980,343,1,4637,4980
8279126,100,156,6.8,2280,156,1,2124,2280
1.00E+12,310,190,5,3800,570,3,10830,11400
1.00E+12,205,2065,31.5,6560,2065,1,4495,6560
6615244,310,261,14.5,1800,1044,4,6156,7200
8333620,310,528,14.5,3650,3696,7,21854,25550
8039735,601,304,14.5,2100,304,1,1796,2100
8352220,601,272,14.5,1880,272,1,1608,1880
8333620,601,528,14.5,3650,1584,3,9366,10950
1.00E+12,310,344,5,6880,344,1,6536,6880
7900507,310,126,5,2530,1008,8,19232,20240
1.00E+12,340,110,7,1580,110,1,1470,1580
1.00E+12,100,1003,19,5280,1003,1,4277,5280
1.00E+12,310,3247,20.4,15900,3247,1,12653,15900
1.00E+12,100,3453,20.4,16900,3453,1,13447,16900
1.00E+12,100,294,5.9,4950,294,1,4656,4950
1.00E+12,501,75,5.9,1280,150,2,2410,2560
1.00E+12,501,3247,20.4,15900,3247,1,12653,15900
1.00E+12,310,298,10,2980,298,1,2682,2980
2.10E+12,310,268,10,2680,2144,8,19296,21440
7050039,205,465,23.5,1980,465,1,1515,1980
1.00E+12,310,161,16.3,990,322,2,1658,1980
8333658,310,627,16.3,3850,627,1,3223,3850
6610869,310,399,16.3,2450,2394,6,12306,14700
1.00E+12,310,1724,11.6,14800,1724,1,13076,14800
1.00E+12,100,174,11.6,1500,348,2,2652,3000
1.00E+12,100,404,16.3,2480,808,2,4152,4960
1.00E+12,500,36455,28.7,127200,36455,1,90745,127200
1.00E+12,500,34162,28.7,119200,34162,1,85038,119200
1.00E+12,310,3401,19,17900,6802,2,28998,35800
8895612,310,1366,19,7190,1366,1,5824,7190
1.00E+12,200,1759,16,11000,3518,2,18482,22000
1.00E+12,200,6585,25.3,26000,6585,1,19415,26000
1.00E+12,200,9118,25.3,36000,9118,1,26882,36000
2.10E+12,200,1300,10,13000,1300,1,11700,13000
1.00E+12,200,1045,5,20900,3135,3,59565,62700
1.00E+12,310,558,10,5580,558,1,5022,5580
2.10E+12,310,7876,41.5,18980,23628,3,33312,56940
1.00E+12,200,1700,10,17000,1700,1,15300,17000
1.00E+12,310,352,8.8,3980,703,2,7257,7960
7928834,310,178,10,1780,712,4,6408,7120
1.00E+12,200,40000,20.1,199000,40000,1,159000,199000
1.00E+12,310,794,9.4,8480,794,1,7686,8480
2.10E+12,310,466,9.4,4980,466,1,4514,4980
7279518,310,344,9.3,3680,344,1,3336,3680
7588534,310,70,7,1000,3290,47,43710,47000
8601310,310,243,7,3480,243,1,3237,3480
8453038,310,173,7,2480,173,1,2307,2480
1.00E+12,310,558,7,7980,1116,2,14844,15960
1.00E+12,310,1048,7,14980,2096,2,27864,29960
1.00E+12,500,1450,5,29000,1450,1,27550,29000
8797937,310,152,7,2180,304,2,4056,4360
1.00E+12,310,187,7,2680,374,2,4986,5360
1.00E+12,601,987,11.6,8480,987,1,7493,8480
10229292,310,249,6.3,3980,249,1,3731,3980
1.00E+12,310,350,11.7,2980,700,2,5260,5960
1.00E+12,310,351,11.8,2980,1052,3,7888,8940
1.00E+12,340,1589,19.9,7980,1589,1,6391,7980
1.00E+12,310,173,7,2480,346,2,4614,4960
6820123,310,220,7,3150,2420,11,32230,34650
1.00E+12,310,1092,7,15600,1092,1,14508,15600
7695322,310,179,5,3580,716,4,13604,14320
1.00E+12,200,41692,24.7,169000,41692,1,127308,169000
1.00E+12,310,398,10,3980,1990,5,17910,19900
1.00E+12,310,1190,10,11900,1190,1,10710,11900
2.10E+12,310,158,10,1580,316,2,2844,3160
2.10E+12,310,120,10,1200,360,3,3240,3600
1.00E+12,310,528,10,5280,1056,2,9504,10560
8500033,310,514,9.4,5480,514,1,4966,5480
1.00E+12,310,460,9.4,4900,919,2,8881,9800
1.00E+12,310,186,9.4,1980,1486,8,14354,15840
1.00E+12,310,279,9.4,2980,279,1,2701,2980
8116426,310,204,9.4,2180,204,1,1976,2180
2.10E+12,205,1000,20,5000,1000,1,4000,5000
1.00E+12,310,49,5,980,1666,34,31654,33320
8104635,310,59,5,1180,531,9,10089,10620
2.10E+12,310,79,5,1580,948,12,18012,18960
1.00E+12,310,60,5,1200,300,5,5700,6000
1.00E+12,310,49,10,490,2940,60,26460,29400
1.00E+12,310,290,10,2900,290,1,2610,2900
1.00E+12,205,4491,45,9980,22455,5,27445,49900
1.00E+12,310,598,10,5980,598,1,5382,5980
1.00E+12,340,61,6.2,980,183,3,2757,2940
1.00E+12,100,4174,24.8,16800,4174,1,12626,16800
,,,,,,,,
1.00E+12,310,279,10,2790,2232,8,20088,22320
1.00E+12,200,8850,15,59000,8850,1,50150,59000
1.00E+12,500,55304,30.9,179000,55304,1,123696,179000
1.00E+12,310,248,10,2480,496,2,4464,4960
1.00E+12,501,5236,6,88000,5236,1,82764,88000
1.00E+12,501,2314,5.9,38900,2314,1,36586,38900
1.00E+12,200,16411,15,109411,16411,1,93000,109411
2.10E+12,310,3024,28,10800,15120,5,38880,54000
2.10E+12,310,898,10,8980,898,1,8082,8980
1.00E+12,310,980,10,9800,4900,5,44100,49000
2.10E+12,200,3024,28,10800,15120,5,38880,54000
1.00E+12,310,15500,14.1,110000,15500,1,94500,110000
1.00E+12,200,12000,5,240000,36000,3,684000,720000
6615161,601,324,5,6480,324,1,6156,6480
2.10E+12,200,3000,33.4,8980,6000,2,11960,17960
2.10E+12,200,9900,50,19800,9900,1,9900,19800
1.00E+12,310,593,7,8480,593,1,7887,8480
2.10E+12,310,138,7,1980,828,6,11052,11880
1.00E+12,310,1106,7,15800,29862,27,396738,426600
8886936,310,144,5,2880,864,6,16416,17280
9707916,310,139,5,2780,2085,15,39615,41700
7622804,310,429,5,8580,429,1,8151,8580
1.00E+12,310,370,5,7400,740,2,14060,14800
1.00E+12,100,9980,10,99800,9980,1,89820,99800
1.00E+12,310,208,7,2980,2288,11,30492,32780
1.00E+12,511,1017,53.5,1900,2033,2,1767,3800
1.00E+12,511,4232,56.6,7480,25394,6,19486,44880
7628565,100,688,17.7,3880,688,1,3192,3880
1.00E+12,310,435,3.7,11900,435,1,11465,11900
6824215,310,994,35.8,2780,2983,3,5357,8340
1.00E+12,310,246,6.9,3590,246,1,3344,3590
8327959,310,96,6.9,1400,96,1,1304,1400
1.00E+12,310,1026,6.9,14880,1026,1,13854,14880
1.00E+12,240,323,9,3600,646,2,6554,7200
1.00E+12,200,40114,24,167300,40114,1,127186,167300
1.00E+12,310,1770,11.8,15000,1770,1,13230,15000
1.00E+12,200,5979,20.6,29000,5979,1,23021,29000
1.00E+12,501,5979,20.6,29000,5979,1,23021,29000
1.00E+12,200,17040,8,213000,17040,1,195960,213000
1.00E+12,500,8150,16.3,50000,8150,1,41850,50000
1.00E+12,200,4810,20.9,23000,4810,1,18190,23000
1.00E+12,200,14900,10,149000,14900,1,134100,149000
2.10E+12,310,895,5,17900,6265,7,119035,125300
8983477,340,320,7,4580,320,1,4260,4580
9699059,310,1398,10,13980,1398,1,12582,13980
1.00E+12,340,614,7,8780,614,1,8166,8780
1.00E+12,310,168,10,1680,504,3,4536,5040
1.00E+12,310,230,10,2300,460,2,4140,4600
1.00E+12,310,208,7,2980,832,4,11088,11920
1.00E+12,310,208,7,2980,1040,5,13860,14900
6612008,310,166,7,2380,166,1,2214,2380
1.00E+12,310,341,8.5,4000,341,1,3659,4000
10533253,310,341,8.5,4000,341,1,3659,4000
1.00E+12,310,297,8.5,3480,297,1,3183,3480
1.00E+12,310,593,7,8480,5337,9,70983,76320
8333662,240,502,16.3,3080,2008,4,10312,12320
1.00E+12,300,109,1,10900,109,1,10791,10900
1.00E+12,200,9430,19.2,49000,18860,2,79140,98000
1.00E+12,310,99,5,1980,891,9,16929,17820
1.00E+12,200,8850,15,59000,8850,1,50150,59000
1.00E+12,340,875,7,12500,875,1,11625,12500
1.00E+12,340,243,7,3480,243,1,3237,3480
1.00E+12,340,558,7,7980,558,1,7422,7980
7899566,310,149,5,2980,298,2,5662,5960
1.00E+12,200,9440,16,59000,9440,1,49560,59000
1.00E+12,310,199,10,1990,199,1,1791,1990
1.00E+12,200,54889,28.7,191520,54889,1,136631,191520
1.00E+12,205,2800,28.6,9780,11200,4,27920,39120
1.00E+12,310,1434,9.6,14980,1434,1,13546,14980
1.00E+12,310,1626,9.6,16980,1626,1,15354,16980
2.10E+12,310,696,11.6,5980,696,1,5284,5980
2.10E+12,310,1753,25.6,6850,3506,2,10194,13700
1.00E+12,200,5320,15,35500,10640,2,60360,71000
8333640,340,315,7,4500,945,3,12555,13500
1.00E+12,340,56,7,800,168,3,2232,2400
1.00E+12,200,3990,20,19950,3990,1,15960,19950
1.00E+12,200,2290,3.3,69000,4580,2,133420,138000
1.00E+12,200,3402,9,37800,3402,1,34398,37800
1.00E+12,310,645,5,12900,1290,2,24510,25800
1.00E+12,200,720,2.1,34800,720,1,34080,34800
1.00E+12,310,858,10,8580,7722,9,69498,77220
1.00E+12,310,432,14.5,2980,432,1,2548,2980
2.10E+12,601,1116,14.5,7700,1116,1,6584,7700
1.00E+12,310,6602,19.2,34300,6602,1,27698,34300
1.00E+12,200,14002,5,282300,14002,1,268298,282300
1.00E+12,300,14002,5,282300,14002,1,268298,282300
1.00E+12,200,4500,15,30000,40500,9,229500,270000
1.00E+12,200,4830,8,60400,4830,1,55570,60400
1.00E+12,310,549,7.9,6980,549,1,6431,6980
1.00E+12,310,753,7.9,9580,753,1,8827,9580
9653425,310,360,7.9,4580,360,1,4220,4580
1.00E+12,310,219,7.9,2780,437,2,5123,5560
2.10E+12,205,1196,20,5980,11960,10,47840,59800
1.00E+12,200,102834,5.9,1740000,102834,1,1637166,1740000
1.00E+12,500,102834,5.9,1740000,102834,1,1637166,1740000
1.00E+12,200,280,10,2800,280,1,2520,2800
1.00E+12,310,682,8.5,7980,682,1,7298,7980
1.00E+12,310,499,5,9980,499,1,9481,9980
1.00E+12,200,1930,5.5,34800,3860,2,65740,69600
1.00E+12,200,1780,15,11900,5340,3,30360,35700
1.00E+12,200,3040,20,15200,3040,1,12160,15200
1.00E+12,310,960,5,19200,960,1,18240,19200
8976246,310,39,5,780,9594,246,182286,191880
1.00E+12,310,149,5,2980,298,2,5662,5960
1.00E+12,310,499,5,9980,499,1,9481,9980
1.00E+12,511,3927,52.5,7480,7854,2,7106,14960
1.00E+12,100,3927,52.5,7480,7854,2,7106,14960
1.00E+12,200,8400,20,42000,8400,1,33600,42000
1.00E+12,340,1500,13.7,10980,6000,4,37920,43920
1.00E+12,310,60,5,1200,60,1,1140,1200
1.00E+12,601,2835,14.3,19800,2835,1,16965,19800
1.00E+12,601,1400,14.3,9800,1400,1,8400,9800
6613854,310,711,14.3,4980,711,1,4269,4980
1.00E+12,310,1400,14.3,9800,1400,1,8400,9800
8082558,340,398,6.7,5980,398,1,5582,5980
1.00E+12,200,2950,5,59000,2950,1,56050,59000
1.00E+12,310,0,0,9900,0,1,9900,9900
1.00E+12,200,1900,20,9500,1900,1,7600,9500
1.00E+12,310,149,5,2980,298,2,5662,5960
1.00E+12,310,798,10,7980,798,1,7182,7980
1.00E+12,310,598,10,5980,1196,2,10764,11960
2.10E+12,310,343,7,4900,343,1,4557,4900
2.10E+12,310,903,7,12900,1806,2,23994,25800
7642205,310,40,5,800,240,6,4560,4800
2.10E+12,310,249,5,4980,249,1,4731,4980
2.10E+12,200,7259,38.2,18980,50813,7,82047,132860
1.00E+12,310,590,10,5900,590,1,5310,5900
1.00E+12,310,68,10,680,204,3,1836,2040
1.00E+12,310,9291,16.3,57000,9291,1,47709,57000
7050044,310,208,7,2980,4576,22,60984,65560
1.00E+12,310,342,5,6850,2052,6,39048,41100
1.00E+12,310,8096,11.6,69500,8096,1,61404,69500
1.00E+12,100,8096,11.6,69500,8096,1,61404,69500
1.00E+12,200,165,3,5500,165,1,5335,5500
8328977,340,68,6.9,980,340,5,4560,4900
7024783,340,2016,7,28800,2016,1,26784,28800
1.00E+12,340,2877,7,41100,2877,1,38223,41100
1.00E+12,310,499,10,4990,1996,4,17964,19960
1.00E+12,310,150,10,1500,300,2,2700,3000
1.00E+12,310,3357,4.2,79800,3357,1,76443,79800
1.00E+12,200,2700,20,13500,10800,4,43200,54000
1.00E+12,310,695,5,13900,2085,3,39615,41700
1.00E+12,310,74,5,1480,1110,15,21090,22200
1.00E+12,310,791,8.6,9180,791,1,8389,9180
1.00E+12,310,219,5.6,3880,874,4,14646,15520
1.00E+12,310,162,5.6,2880,162,1,2718,2880
1.00E+12,310,67,5.6,1200,67,1,1133,1200
2.10E+12,310,643,32.5,1980,643,1,1337,1980
2.10E+12,200,2580,15.4,16800,5160,2,28440,33600
1.00E+12,310,222,9,2480,222,1,2258,2480
1.00E+12,310,201,8.9,2250,201,1,2049,2250
1.00E+12,310,299,9,3340,897,3,9123,10020
8118092,310,198,10,1980,396,2,3564,3960
6616270,310,620,10,6200,1860,3,16740,18600
1.00E+12,310,358,10,3580,2864,8,25776,28640
1.00E+12,310,598,10,5980,1196,2,10764,11960
2.10E+12,100,139,5,2780,139,1,2641,2780
2.10E+12,100,349,5,6980,349,1,6631,6980
1.00E+12,310,178,12.3,1450,178,1,1272,1450
1.00E+12,310,844,16.9,4980,844,1,4136,4980
1.00E+12,100,308,12.3,2500,308,1,2192,2500
1.00E+12,100,844,16.9,4980,844,1,4136,4980
1.00E+12,100,1961,12.3,15900,1961,1,13939,15900
6617873,100,505,16.9,2980,505,1,2475,2980
1.00E+12,100,1946,12.3,15780,1946,1,13834,15780
2.10E+12,200,1295,20.8,6225,1295,1,4930,6225
1.00E+12,340,14,0.9,1480,14,1,1466,1480
2.10E+12,340,19,1,1980,19,1,1961,1980
2.10E+12,340,1425,20.8,6850,1425,1,5425,6850
6617477,340,180,7,2580,180,1,2400,2580
6615124,310,237,8.8,2680,237,1,2443,2680
2.10E+12,310,264,8.9,2980,264,1,2716,2980
1.00E+12,205,2075,26,7980,2075,1,5905,7980
1.00E+12,310,12879,18.8,68600,12879,1,55721,68600
1.00E+12,310,249,5,4980,249,1,4731,4980
2.10E+12,200,4440,34.7,12800,4440,1,8360,12800
1.00E+12,200,2088,6.9,30100,2088,1,28012,30100
7695726,310,56,9.7,580,112,2,1048,1160
1.00E+12,310,163,9.7,1680,163,1,1517,1680
1.00E+12,310,640,23,2780,640,1,2140,2780
1.00E+12,310,200,14.5,1380,200,1,1180,1380
2.10E+12,200,3440,21.8,15800,3440,1,12360,15800
1.00E+12,100,200,14.5,1380,200,1,1180,1380
1.00E+12,310,3980,20,19900,7960,2,31840,39800
1.00E+12,310,127,9.2,1380,127,1,1253,1380
1.00E+12,310,198,10,1980,1782,9,16038,17820
2.10E+12,310,1472,37,3980,1472,1,2508,3980
1.00E+12,205,1887,37,5100,7548,4,12852,20400
2.10E+12,205,1472,37,3980,1472,1,2508,3980
1.00E+12,205,3318,42.5,7800,3318,1,4482,7800
1.00E+12,200,10350,15,69000,10350,1,58650,69000
2.10E+12,200,1000,14.3,6980,1000,1,5980,6980
1.00E+12,500,2690,6.9,39100,2690,1,36410,39100
1.00E+12,310,566,19,2980,566,1,2414,2980
6946495,310,208,7,2980,416,2,5544,5960
1.00E+12,310,628,7,8980,1256,2,16704,17960
1.00E+12,310,1980,10,19800,1980,1,17820,19800
7460695,310,1126,19,5930,1126,1,4804,5930
10051303,310,1229,14.5,8480,1229,1,7251,8480
10698740,310,1229,14.5,8480,1229,1,7251,8480
2.10E+12,100,272,14.5,1880,272,1,1608,1880
1.00E+12,310,490,10,4900,1470,3,13230,14700
1.00E+12,310,288,10,2880,576,2,5184,5760
1.00E+12,200,2090,6,34900,8360,4,131240,139600
1.00E+12,500,1990,5,39800,1990,1,37810,39800
8309816,100,118,10,1180,118,1,1062,1180
1.00E+12,340,14507,16.3,89000,14507,1,74493,89000
1.00E+12,310,1145,9.6,11900,1145,1,10755,11900
1.00E+12,310,1509,17.8,8500,1509,1,6991,8500
1.00E+12,310,383,9.6,3990,383,1,3607,3990
1.00E+12,200,1586,18.7,8500,1586,1,6914,8500
1.00E+12,200,2660,11.1,24000,2660,1,21340,24000
1.00E+12,200,1500,8,18850,1500,1,17350,18850
2.10E+12,310,1258,11.6,10800,1258,1,9542,10800
8488475,100,1141,16.3,7000,1141,1,5859,7000
2.10E+12,100,347,11.6,2980,694,2,5266,5960
1.00E+12,100,1555,24,6480,1555,1,4925,6480
1.00E+12,310,198,10,1980,396,2,3564,3960
2.10E+12,310,188,10,1880,752,4,6768,7520
6610161,310,246,6.3,3900,246,1,3654,3900
7539816,310,276,6.3,4380,276,1,4104,4380
1.00E+12,310,475,5,9500,475,1,9025,9500
1.00E+12,310,594,5,11880,1188,2,22572,23760
1.00E+12,310,285,5,5700,285,1,5415,5700
2.10E+12,100,168,10,1680,168,1,1512,1680
1.00E+12,100,291,10,2900,291,1,2609,2900
7628565,100,389,10,3880,389,1,3491,3880
1.00E+12,200,2744,28,9800,5488,2,14112,19600
1.00E+12,310,368,10,3680,368,1,3312,3680
2.10E+12,601,225,5,4500,225,1,4275,4500
1.00E+12,310,180,5,3600,180,1,3420,3600
7640754,310,125,5,2500,125,1,2375,2500
1.00E+12,310,352,11.8,2980,704,2,5256,5960
1.00E+12,601,352,11.8,2980,704,2,5256,5960
1.00E+12,310,1374,5,27480,1374,1,26106,27480
1.00E+12,310,276,7,3950,828,3,11022,11850
1.00E+12,310,278,7,3980,834,3,11106,11940
7930804,310,138,7,1980,552,4,7368,7920
7083255,310,122,7,1750,1342,11,17908,19250
1.00E+12,200,1500,15,10000,1500,1,8500,10000
6613777,310,118,7.9,1500,118,1,1382,1500
1.00E+12,100,235,7.9,2980,705,3,8235,8940
1.00E+12,100,386,7.9,4880,386,1,4494,4880
1.00E+12,100,269,7.9,3400,269,1,3131,3400
1.00E+12,501,314,7.9,3980,628,2,7332,7960
1.00E+12,501,1187,7.9,14980,1187,1,13793,14980
1.00E+12,310,1029,5.7,17900,1029,1,16871,17900
1.00E+12,200,3430,10,34300,3430,1,30870,34300
1.00E+12,200,5460,7,78000,5460,1,72540,78000
1.00E+12,205,1500,18.8,7980,7500,5,32400,39900
1.00E+12,310,16244,23.2,70000,16244,1,53756,70000
1.00E+12,200,9156,18.7,49000,9156,1,39844,49000
2.10E+12,310,3483,34.9,9980,27864,8,51976,79840
2.10E+12,310,579,7,8280,3474,6,46206,49680
2.10E+12,200,3483,34.9,9980,27864,8,51976,79840
1.00E+12,310,299,5,5980,299,1,5681,5980
1.00E+12,310,58125,23.3,250000,58125,1,191875,250000
1.00E+12,310,149,5,2980,894,6,16986,17880
2.10E+12,200,1349,16.9,7980,2698,2,13262,15960
1.00E+12,310,488,7,6980,2440,5,32460,34900
1.00E+12,200,15900,10,159000,47700,3,429300,477000
1.00E+12,205,2400,30,8000,2400,1,5600,8000
1.00E+12,205,1200,30,4000,1200,1,2800,4000
1.00E+12,205,6000,30,20000,6000,1,14000,20000
1.00E+12,200,3990,10,39900,3990,1,35910,39900
8039735,601,105,5,2100,210,2,3990,4200
2.10E+12,310,992,9.2,10800,992,1,9808,10800
1.00E+12,310,1498,27.3,5480,1498,1,3982,5480
1.00E+12,310,406,12.7,3200,406,1,2794,3200
8553755,310,444,12.7,3500,444,1,3056,3500
1.00E+12,310,289,12.7,2280,289,1,1991,2280
1.00E+12,310,758,12.7,5980,758,1,5222,5980
1.00E+12,310,1141,17.3,6600,2281,2,10919,13200
1.00E+12,100,112,12.7,880,558,5,3842,4400
1.00E+12,100,118,17.3,680,235,2,1125,1360
1.00E+12,100,138,17.3,800,829,6,3971,4800
1.00E+12,310,1090,10,10900,6540,6,58860,65400
1.00E+12,310,128,10,1280,896,7,8064,8960
2.10E+12,200,6693,33.5,19980,33465,5,66435,99900
8356931,310,745,9.3,7980,745,1,7235,7980
1.00E+12,310,493,9.3,5280,493,1,4787,5280
2.10E+12,310,338,8.5,3980,338,1,3642,3980
1.00E+12,205,2384,17.7,13500,2384,1,11116,13500
1.00E+12,240,1680,40,4200,6720,4,10080,16800
1.00E+12,340,693,7,9900,693,1,9207,9900
1.00E+12,340,306,7,4380,612,2,8148,8760
2.10E+12,340,82,6.9,1180,246,3,3294,3540
1.00E+12,310,456,14.3,3180,456,1,2724,3180
2.10E+12,310,76,4.8,1580,76,1,1504,1580
2.10E+12,200,6609,33.4,19800,6609,1,13191,19800
2.10E+12,200,1240,20.7,5980,1240,1,4740,5980
2.10E+12,200,7238,38.1,18980,7238,1,11742,18980
1.00E+12,205,1158,30.2,3840,1158,1,2682,3840
1.00E+12,200,16110,15,107400,16110,1,91290,107400
1.00E+12,310,2337,13.8,16900,2337,1,14563,16900
8039735,310,186,8.9,2100,186,1,1914,2100
2.10E+12,100,1769,8.9,19980,1769,1,18211,19980
1.00E+12,100,221,8.8,2500,221,1,2279,2500
2.10E+12,501,443,8.9,5000,4430,10,45570,50000
2.10E+12,310,1167,7.3,15980,3502,3,44438,47940
1.00E+12,310,698,10,6980,698,1,6282,6980
8583142,310,478,10,4780,1912,4,17208,19120
6609132,340,194,7,2780,194,1,2586,2780
1.00E+12,500,15540,21,74000,15540,1,58460,74000
8609842,511,360,33.3,1080,14040,39,28080,42120
2.10E+12,310,89,5,1780,356,4,6764,7120
8097995,310,129,5,2580,129,1,2451,2580
7454027,310,138,7,1980,138,1,1842,1980
1.00E+12,310,698,7,9980,1396,2,18564,19960
1.00E+12,310,690,10,6900,1380,2,12420,13800
1.00E+12,310,2788,31,8980,2788,1,6192,8980
8753741,310,198,10,1980,990,5,8910,9900
1.00E+12,310,510,10,5100,1020,2,9180,10200
1.00E+12,310,895,10,8950,895,1,8055,8950
1.00E+12,310,388,9.7,3980,1164,3,10776,11940
6615745,310,249,5,4980,249,1,4731,4980
2.10E+12,240,2712,18.4,14700,5424,2,23976,29400
1.00E+12,310,400,9.3,4280,400,1,3880,4280
1.00E+12,310,478,10,4780,478,1,4302,4780
1.00E+12,200,7864,23.1,34000,7864,1,26136,34000
1.00E+12,200,10409,23.1,45000,10409,1,34591,45000
1.00E+12,500,1396,15.5,9000,4188,3,22812,27000
1.00E+12,310,418,6,6980,418,1,6562,6980
1.00E+12,310,238,6,3980,476,2,7484,7960
6615596,310,458,10,4580,5954,13,53586,59540
1.00E+12,310,900,10,9000,900,1,8100,9000
7164497,310,377,10,3780,377,1,3403,3780
1.00E+12,310,969,10,9700,969,1,8731,9700
7695735,310,49,5,980,98,2,1862,1960
1.00E+12,205,1170,30,3900,18720,16,43680,62400
1.00E+12,310,299,5,5980,299,1,5681,5980
1.00E+12,310,479,5,9580,479,1,9101,9580
6609750,310,348,10,3480,348,1,3132,3480
1.00E+12,310,790,10,7900,1580,2,14220,15800
2.10E+12,310,338,7.5,4480,338,1,4142,4480
1.00E+12,100,4320,19.1,22600,4320,1,18280,22600
1.00E+12,500,8672,22.1,39200,8672,1,30528,39200
2.10E+12,200,1000,6.3,15800,8000,8,118400,126400
2.10E+12,200,5994,30,19980,47952,8,111888,159840
1.00E+12,310,208,7,2980,416,2,5544,5960
1.00E+12,501,409,5,8190,818,2,15562,16380
1.00E+12,310,280,7,4000,1400,5,18600,20000
1.00E+12,300,14500,14.5,100000,14500,1,85500,100000
2.10E+12,310,558,7,7980,2232,4,29688,31920
8537421,310,207,7,2960,2691,13,35789,38480
1.00E+12,205,4194,30,13980,12582,3,29358,41940
8645072,310,2360,40,5900,7080,3,10620,17700
1.00E+12,310,360,10,3600,360,1,3240,3600
1.00E+12,200,1770,3,59000,1770,1,57230,59000
1.00E+12,300,1500,7.9,18980,10500,7,122360,132860
9669780,310,2201,37.4,5880,2201,1,3679,5880
10627394,310,418,10,4180,1254,3,11286,12540
1.00E+12,200,15984,20.9,76300,15984,1,60316,76300
1.00E+12,310,551,11.8,4680,551,1,4129,4680
1.00E+12,100,551,11.8,4680,551,1,4129,4680
1.00E+12,100,448,11.8,3800,448,1,3352,3800
1.00E+12,100,433,11.8,3680,866,2,6494,7360
1.00E+12,501,315,11.8,2680,315,1,2365,2680
6618348,501,584,11.8,4950,584,1,4366,4950
1.00E+12,500,1510,6.3,23800,1510,1,22290,23800
8480215,310,298,10,2980,1788,6,16092,17880
8694843,310,498,10,4980,2490,5,22410,24900
6615250,205,630,30,2100,1260,2,2940,4200
1.00E+12,240,946,28,3380,8514,9,21906,30420
1.00E+12,310,1490,10,14900,4470,3,40230,44700
1.00E+12,200,3596,20,17980,35960,10,143840,179800
2.10E+12,310,5594,41.5,13480,11188,2,15772,26960
1.00E+12,310,298,10,2980,1490,5,13410,14900
2.10E+12,200,3692,37,9980,7384,2,12576,19960
2.10E+12,310,274,5,5480,548,2,10412,10960
2.10E+12,310,375,5,7500,750,2,14250,15000
7095585,310,249,5,4980,9711,39,184509,194220
1.00E+12,310,551,14.5,3800,1102,2,6498,7600
1.00E+12,310,551,14.5,3800,1102,2,6498,7600
1.00E+12,501,609,14.5,4200,609,1,3591,4200
1.00E+12,501,609,14.5,4200,609,1,3591,4200
1.00E+12,501,551,14.5,3800,1102,2,6498,7600
1.00E+12,501,1087,14.5,7500,1087,1,6413,7500
8038256,310,99,5,1980,1089,11,20691,21780
1.00E+12,310,194,5,3880,194,1,3686,3880
1.00E+12,205,3778,38.6,9780,3778,1,6002,9780
1.00E+12,310,730,10,7300,730,1,6570,7300
1.00E+12,310,590,5,11800,2360,4,44840,47200
1.00E+12,200,2970,15,19800,2970,1,16830,19800
2.10E+12,310,233,8.7,2680,233,1,2447,2680
1.00E+12,310,260,8.7,2980,779,3,8161,8940
1.00E+12,310,288,10,2880,864,3,7776,8640
2.10E+12,310,355,20.3,1750,3195,9,12555,15750
1.00E+12,200,8064,22.4,36000,8064,1,27936,36000
1.00E+12,310,210,7,3000,210,1,2790,3000
1.00E+12,310,544,7,7780,2720,5,36180,38900
1.00E+12,310,428,10,4280,856,2,7704,8560
10733416,310,504,10,5040,1512,3,13608,15120
1.00E+12,601,149,5,2980,149,1,2831,2980
1.00E+12,310,558,7,7980,558,1,7422,7980
1.00E+12,310,821,9.1,8980,821,1,8159,8980
1.00E+12,310,638,9.1,6980,638,1,6342,6980
1.00E+12,310,913,9.1,9980,1825,2,18135,19960
1.00E+12,310,743,9.3,7980,743,1,7237,7980
1.00E+12,501,995,5,19900,1990,2,37810,39800
1.00E+12,310,1130,19,5950,2260,2,9640,11900
1.00E+12,300,15485,16.3,95000,46455,3,238545,285000
1.00E+12,310,4838,25.6,18900,9676,2,28124,37800
6610189,340,47,5,940,94,2,1786,1880
1.00E+12,200,9477,17.6,54000,9477,1,44523,54000
1.00E+12,310,99,5,1980,297,3,5643,5940
8491779,310,300,5,6000,300,1,5700,6000
1.00E+12,310,199,5,3980,597,3,11343,11940
1.00E+12,200,4480,14,32000,4480,1,27520,32000
1.00E+12,300,18331,20.9,87500,18331,1,69169,87500
2.10E+12,310,6973,34.9,19980,34865,5,65035,99900
2.10E+12,310,82,6.9,1180,1558,19,20862,22420
1.00E+12,310,890,10,8900,2670,3,24030,26700
1.00E+12,500,22050,27.5,80100,22050,1,58050,80100
1.00E+12,500,8720,24.8,35100,8720,1,26380,35100
1.00E+12,500,28890,24.9,116100,28890,1,87210,116100
1.00E+12,500,12430,26,47790,24860,2,70720,95580
1.00E+12,310,4607,14.4,32000,4607,1,27393,32000
1.00E+12,200,3167,14.4,22000,3167,1,18833,22000
1.00E+12,200,5327,14.4,37000,5327,1,31673,37000
1.00E+12,200,4607,14.4,32000,4607,1,27393,32000
1.00E+12,310,1198,10,11980,1198,1,10782,11980
1.00E+12,310,278,7,3980,556,2,7404,7960
6613198,310,2220,10,22200,2220,1,19980,22200
1.00E+12,310,299,7,4280,5083,17,67677,72760
10701325,310,313,7,4480,626,2,8334,8960
7648614,601,137,14.4,950,274,2,1626,1900
1.00E+12,310,98,10,980,392,4,3528,3920
7049673,310,130,14.4,900,260,2,1540,1800
1.00E+12,310,3139,6.4,48980,6278,2,91682,97960
1.00E+12,200,5250,15,35000,5250,1,29750,35000
1.00E+12,310,5205,14.5,35900,5205,1,30695,35900
8110997,310,817,7,11680,2451,3,32589,35040
1.00E+12,340,30787,28.2,109000,30787,1,78213,109000
6870732,310,152,7,2180,152,1,2028,2180
2.10E+12,310,488,7,6980,1464,3,19476,20940
1.00E+12,310,387,8.6,4480,1546,4,16374,17920
6609419,310,472,8.6,5480,472,1,5008,5480
1.00E+12,205,8160,30,27200,16320,2,38080,54400
6609759,100,473,7.9,5980,473,1,5507,5980
1.00E+12,100,378,7.9,4780,378,1,4402,4780
7695680,501,76,7.8,980,152,2,1808,1960
1.00E+12,200,7451,14.6,51000,7451,1,43549,51000
7465142,310,845,5,16900,1690,2,32110,33800
1.00E+12,310,5180,10,51800,5180,1,46620,51800
1.00E+12,310,499,5,9980,499,1,9481,9980
8634479,310,949,5,18980,949,1,18031,18980
1.00E+12,310,2646,33.5,7900,2646,1,5254,7900
1.00E+12,200,18855,21,90000,18855,1,71145,90000
1.00E+12,200,31833,23.3,136500,31833,1,104667,136500
1.00E+12,300,31833,23.3,136500,31833,1,104667,136500
1.00E+12,200,585,3,19500,585,1,18915,19500
6609426,310,254,6.9,3680,254,1,3426,3680
1.00E+12,310,54,6.9,780,324,6,4356,4680
9033680,310,240,6.9,3480,240,1,3240,3480
1.00E+12,100,1100,5,22000,1100,1,20900,22000
1.00E+12,240,3332,28,11900,6664,2,17136,23800
2.10E+12,200,1770,20.3,8700,1770,1,6930,8700
1.00E+12,310,224,5,4490,672,3,12798,13470
1.00E+12,310,538,10,5380,1076,2,9684,10760
1.00E+12,310,390,7,5580,780,2,10380,11160
1.00E+12,310,240,7,3430,960,4,12760,13720
1.00E+12,310,24,6.9,350,960,40,13040,14000
1.00E+12,310,33330,23.3,143100,33330,1,109770,143100
2.10E+12,310,413,7,5900,1239,3,16461,17700
1.00E+12,310,138,7,1980,1380,10,18420,19800
1.00E+12,310,696,11.6,5980,696,1,5284,5980
1.00E+12,100,696,11.6,5980,696,1,5284,5980
907389,200,27260,14.5,188000,27260,1,160740,188000
1.00E+12,310,288,10,2880,1728,6,15552,17280
6610161,310,390,10,3900,3900,10,35100,39000
1.00E+12,310,204,9,2280,1226,6,12454,13680
7695348,310,166,9,1850,166,1,1684,1850
1.00E+12,100,204,9,2280,1226,6,12454,13680
1.00E+12,100,179,9,2000,179,1,1821,2000
1.00E+12,501,806,9,8980,806,1,8174,8980
1.00E+12,310,278,7,3980,1390,5,18510,19900
1.00E+12,310,349,5,6980,698,2,13262,13960
8592353,310,134,5,2680,938,7,17822,18760
2.10E+12,310,7853,22.4,35000,15706,2,54294,70000
2.10E+12,500,7853,22.4,35000,15706,2,54294,70000
1.00E+12,310,1500,10,15000,1500,1,13500,15000
2.10E+12,100,1140,21.6,5280,1140,1,4140,5280
2.10E+12,100,199,2,9980,199,1,9781,9980
2.10E+12,501,23,1.9,1180,46,2,2314,2360
1.00E+12,310,998,10,9980,3992,4,35928,39920
1.00E+12,200,17696,28,63200,17696,1,45504,63200
2.10E+12,100,424,5,8480,424,1,8056,8480
6615596,100,458,10,4580,1374,3,12366,13740
7559023,310,195,5,3900,390,2,7410,7800
9704172,100,74,1,7480,74,1,7406,7480
2.10E+12,100,64,1,6430,64,1,6366,6430
1.00E+12,100,5178,19.2,26900,5178,1,21722,26900
1.00E+12,310,244,9.8,2500,244,1,2256,2500
1.00E+12,310,391,9.8,4000,391,1,3609,4000
1.00E+12,310,264,5,5280,1056,4,20064,21120
1.00E+12,200,4749,10.3,46200,4749,1,41451,46200
8333663,310,49,4.9,990,49,1,941,990
1.00E+12,310,184,5,3680,2392,13,45448,47840
1.00E+12,310,49,5,980,1813,37,34447,36260
2.10E+12,200,3000,16.9,17800,42000,14,207200,249200
1.00E+12,310,117,7,1680,585,5,7815,8400
1.00E+12,310,485,16.3,2980,970,2,4990,5960
1.00E+12,310,278,10,2780,834,3,7506,8340
7006681,310,2657,9.6,27600,2657,1,24943,27600
1.00E+12,340,278,7,3980,278,1,3702,3980
1.00E+12,340,140,7,2000,140,1,1860,2000
1.00E+12,200,1935,15,12900,1935,1,10965,12900
1.00E+12,200,545,5,10900,545,1,10355,10900
1.00E+12,100,26399,52.9,49900,26399,1,23501,49900
1.00E+12,501,26399,52.9,49900,26399,1,23501,49900
7351612,310,84,7,1200,336,4,4464,4800
1.00E+12,310,495,10,4950,495,1,4455,4950
1.00E+12,310,50,10,500,100,2,900,1000
1.00E+12,310,4045,23,17555,4045,1,13510,17555
1.00E+12,100,413,11.8,3500,413,1,3087,3500
1.00E+12,501,413,11.8,3500,413,1,3087,3500
1.00E+12,310,110,5,2200,110,1,2090,2200
1.00E+12,310,149,5,2980,745,5,14155,14900
6615474,501,301,11.8,2560,301,1,2259,2560
8527105,501,1177,11.8,9980,1177,1,8803,9980
2.10E+12,501,1177,11.8,9980,3531,3,26409,29940
1.00E+12,100,338,7.9,4280,338,1,3942,4280
2.10E+12,501,418,7,5980,836,2,11124,11960
6860259,501,626,7.9,7900,1252,2,14548,15800
1.00E+12,310,30000,17.8,169000,60000,2,278000,338000
6621453,310,380,9.5,3980,380,1,3600,3980
1.00E+12,310,94,9.5,980,187,2,1773,1960
6609572,310,148,10,1480,1628,11,14652,16280
454411,200,4800,15,32000,4800,1,27200,32000
6820123,310,157,5,3150,2669,17,50881,53550
8239906,310,851,19,4480,851,1,3629,4480
1.00E+12,200,2962,18.8,15780,2962,1,12818,15780
1.00E+12,200,14040,17.6,80000,14040,1,65960,80000
,,,,,,,,
1.00E+12,200,1690,10,16900,1690,1,15210,16900
1.00E+12,200,1200,10,12000,1200,1,10800,12000
1.00E+12,310,1290,10,12900,1290,1,11610,12900
1.00E+12,200,3750,5,75000,3750,1,71250,75000
8844794,310,215,10.9,1980,215,1,1765,1980
9014185,501,418,10.9,3840,418,1,3422,3840
1.00E+12,200,6490,18.5,35100,6490,1,28610,35100
1.00E+12,310,410,11.4,3600,410,1,3190,3600
1.00E+12,310,1435,14.5,9900,1435,1,8465,9900
1.00E+12,200,15750,15,105000,31500,2,178500,210000
1.00E+12,310,674,9.8,6880,674,1,6206,6880
1.00E+12,310,194,9.8,1980,194,1,1786,1980
1.00E+12,310,117,9.8,1200,117,1,1083,1200
1.00E+12,200,7930,18,44100,7930,1,36170,44100
1.00E+12,200,1760,16,11000,1760,1,9240,11000
1.00E+12,200,6740,17.2,39200,13480,2,64920,78400
1.00E+12,310,336,7,4800,672,2,8928,9600
8941522,310,418,7,5980,1254,3,16686,17940
2.10E+12,310,553,7,7900,553,1,7347,7900
1.00E+12,310,826,7,11800,826,1,10974,11800
1.00E+12,200,8820,18,49000,8820,1,40180,49000
1.00E+12,340,411,7,5880,1233,3,16407,17640
1.00E+12,310,429,5,8580,2574,6,48906,51480
7469562,310,869,10.9,7980,869,1,7111,7980
7022294,240,1080,40,2700,7560,7,11340,18900
1.00E+12,310,390,10,3900,1560,4,14040,15600
1.00E+12,240,298,10,2980,7748,26,69732,77480
1.00E+12,240,298,10,2980,8344,28,75096,83440
1.00E+12,200,4900,10,49000,4900,1,44100,49000
1.00E+12,200,4710,15,31400,18840,4,106760,125600
1.00E+12,310,7972,53.5,14900,31886,4,27714,59600
1.00E+12,310,418,7,5980,2090,5,27810,29900
8514055,310,69,7,990,69,1,921,990
1.00E+12,310,248,10,2480,2232,9,20088,22320
1.00E+12,310,178,10,1780,534,3,4806,5340
1.00E+12,200,131230,14.7,891400,131230,1,760170,891400
1.00E+12,200,5040,20,25200,5040,1,20160,25200
1.00E+12,200,250,4.9,5100,500,2,9700,10200
6904933,310,134,5,2680,134,1,2546,2680
8117982,310,219,5,4380,219,1,4161,4380
1.00E+12,310,203,6.6,3080,203,1,2877,3080
6957391,310,303,6.6,4580,303,1,4277,4580
7095585,310,329,6.6,4980,329,1,4651,4980
1.00E+12,310,3552,14.5,24500,3552,1,20948,24500
1.00E+12,200,2885,14.5,19900,2885,1,17015,19900
1.00E+12,310,9308,11.6,79900,9308,1,70592,79900
6610869,310,449,18.3,2450,449,1,2001,2450
1.00E+12,310,964,13.8,6980,964,1,6016,6980
1.00E+12,200,6330,11.1,57000,6330,1,50670,57000
1.00E+12,500,19917,23.4,85000,19917,1,65083,85000
6615122,240,1039,16.3,6380,4156,4,21364,25520
1.00E+12,310,251,8.7,2880,501,2,5259,5760
7050044,310,261,8.7,2980,2605,10,27195,29800
1.00E+12,310,520,8.7,5980,520,1,5460,5980
1.00E+12,310,598,10,5980,2392,4,21528,23920
1.00E+12,200,4880,9.8,49900,9760,2,90040,99800
1.00E+12,200,7800,20,39000,15600,2,62400,78000
1.00E+12,200,2400,15,16000,19200,8,108800,128000
1.00E+12,310,469,9.4,5000,937,2,9063,10000
1.00E+12,100,835,9.4,8900,5011,6,48389,53400
1.00E+12,205,10660,39.2,27200,42640,4,66160,108800
7255206,310,108,10,1080,324,3,2916,3240
1.00E+12,200,52270,11.1,470500,52270,1,418230,470500
,,,,,,,,
1.00E+12,310,643,10.9,5900,643,1,5257,5900
1.00E+12,310,1351,10.9,12400,1351,1,11049,12400
1.00E+12,310,672,10.9,6180,672,1,5508,6180
1.00E+12,310,283,10.9,2600,283,1,2317,2600
1.00E+12,100,324,10.9,2980,324,1,2656,2980
1.00E+12,100,643,10.9,5900,643,1,5257,5900
1.00E+12,100,817,10.9,7500,817,1,6683,7500
1.00E+12,501,542,10.9,4980,1084,2,8876,9960
6610189,310,109,11.6,940,218,2,1662,1880
1.00E+12,310,593,7,8480,2965,5,39435,42400
6608986,310,215,7,3080,215,1,2865,3080
1.00E+12,310,1680,9.4,17900,1680,1,16220,17900
1.00E+12,310,184,9.3,1980,184,1,1796,1980
1.00E+12,310,184,9.3,1980,184,1,1796,1980
1.00E+12,310,3950,5,79000,3950,1,75050,79000
9014185,310,346,9,3840,691,2,6989,7680
1.00E+12,310,148,10,1480,1924,13,17316,19240
1.00E+12,310,589,7,8420,589,1,7831,8420
2.10E+12,310,227,7,3250,681,3,9069,9750
1.00E+12,310,460,10,4600,460,1,4140,4600
1.00E+12,310,2015,14.5,13900,2015,1,11885,13900
1.00E+12,310,488,10,4880,488,1,4392,4880
1.00E+12,240,572,19.2,2980,1144,2,4816,5960
7275088,310,214,5.9,3600,214,1,3386,3600
1.00E+12,501,199,5,3980,398,2,7562,7960
1.00E+12,501,146,5.9,2480,146,1,2334,2480
1.00E+12,200,9345,15,62300,18690,2,105910,124600
7165280,310,50,5,1000,300,6,5700,6000
1.00E+12,200,21000,15,140000,21000,1,119000,140000
2.10E+12,100,301,14.5,2080,301,1,1779,2080
1.00E+12,100,756,19,3980,756,1,3224,3980
2.10E+12,100,243,14.5,1680,243,1,1437,1680
1.00E+12,200,9750,15,65000,9750,1,55250,65000
1.00E+12,200,13680,17.5,78000,13680,1,64320,78000
1.00E+12,310,2432,7,34750,2432,1,32318,34750
7693530,340,648,16.3,3980,1296,2,6664,7960
1.00E+12,340,648,16.3,3980,1296,2,6664,7960
1.00E+12,200,16680,17.8,93870,16680,1,77190,93870
1.00E+12,340,558,7,7980,558,1,7422,7980
2.10E+12,200,600,15.1,3980,1200,2,6760,7960
1.00E+12,310,1974,9.9,19980,1974,1,18006,19980
1.00E+12,200,600,15,4000,3000,5,17000,20000
2.10E+12,310,135,8,1680,135,1,1545,1680
1.00E+12,310,455,6.9,6600,455,1,6145,6600
1.00E+12,501,688,6.9,9980,688,1,9292,9980
1.00E+12,200,1173,3,39100,1173,1,37927,39100
6610869,240,289,11.8,2450,289,1,2161,2450
2.10E+12,100,29,2,1480,29,1,1451,1480
1.00E+12,200,1300,13,10000,1300,1,8700,10000
1.00E+12,310,35204,24.6,143200,35204,1,107996,143200
1.00E+12,310,5169,10.4,49500,5169,1,44331,49500
1.00E+12,310,173,7,2480,173,1,2307,2480
1.00E+12,200,2860,20,14300,2860,1,11440,14300
1.00E+12,310,4971,5.9,84000,4971,1,79029,84000
1.00E+12,310,2544,5.9,43000,2544,1,40456,43000
1.00E+12,310,236,7,3380,236,1,3144,3380
2.10E+12,200,798,16.3,4900,798,1,4102,4900
1.00E+12,310,128,10,1280,1024,8,9216,10240
1.00E+12,511,690,50,1380,1380,2,1380,2760
1.00E+12,310,528,19,2780,528,1,2252,2780
1.00E+12,100,258,23.5,1100,258,1,842,1100
1.00E+12,100,528,19,2780,528,1,2252,2780
2.10E+12,200,243,15,1620,2916,12,16524,19440
1.00E+12,310,296,6.6,4480,592,2,8368,8960
1.00E+12,310,88,10,880,616,7,5544,6160
8103813,310,425,10,4250,1700,4,15300,17000
1.00E+12,310,468,10,4680,1404,3,12636,14040
1.00E+12,310,577,14.5,3980,577,1,3403,3980
9593806,310,298,10,2980,298,1,2682,2980
1.00E+12,500,11578,20.2,57320,11578,1,45742,57320
1.00E+12,310,558,7,7980,1116,2,14844,15960
1.00E+12,310,2723,7,38900,5446,2,72354,77800
1.00E+12,310,201,7,2880,603,3,8037,8640
1.00E+12,310,455,7,6500,455,1,6045,6500
1.00E+12,310,1135,14.4,7900,2270,2,13530,15800
8103649,100,187,7.9,2380,187,1,2193,2380
1.00E+12,501,68,6.9,980,4080,60,54720,58800
1.00E+12,200,14265,15.9,90000,14265,1,75735,90000
1.00E+12,240,732,6.8,10780,732,1,10048,10780
1.00E+12,200,4690,10,46900,9380,2,84420,93800
2.10E+12,310,1488,18.6,7980,2976,2,12984,15960
2.10E+12,310,1890,10,18900,13230,7,119070,132300
1.00E+12,310,998,10,9980,8982,9,80838,89820
6609554,310,47,4.9,950,47,1,903,950
1.00E+12,310,499,5,9980,998,2,18962,19960
1.00E+12,310,59,5,1180,118,2,2242,2360
7936333,310,395,5.7,6980,395,1,6585,6980
2.10E+12,310,265,5.7,4680,265,1,4415,4680
1.00E+12,310,698,10,6980,2792,4,25128,27920
1.00E+12,310,798,10,7980,7182,9,64638,71820
1.00E+12,310,218,10,2180,1090,5,9810,10900
1.00E+12,310,120,10,1200,600,5,5400,6000
8602158,310,460,9.9,4650,460,1,4190,4650
8118092,310,196,9.9,1980,196,1,1784,1980
1.00E+12,200,18500,10,185000,18500,1,166500,185000
1.00E+12,200,6720,22.4,30000,94080,14,325920,420000
1.00E+12,511,290,35,830,7835,27,14575,22410
1.00E+12,200,6821,10.1,67500,6821,1,60679,67500
1.00E+12,310,326,4.1,7980,326,1,7654,7980
1.00E+12,310,285,4.1,6980,285,1,6695,6980
8634515,310,130,4.1,3180,130,1,3050,3180
7708231,310,142,9,1580,142,1,1438,1580
1.00E+12,310,449,9,4980,449,1,4531,4980
1.00E+12,310,586,9,6500,586,1,5914,6500
1.00E+12,310,2146,37,5800,4292,2,7308,11600
1.00E+12,310,1250,37,3380,1250,1,2130,3380
1.00E+12,200,26796,7.9,340000,26796,1,313204,340000
1.00E+12,310,761,7,10880,761,1,10119,10880
1.00E+12,310,367,9.2,3980,367,1,3613,3980
1.00E+12,200,2175,15,14500,2175,1,12325,14500
8052298,310,96,7,1380,3168,33,42372,45540
1.00E+12,310,488,7,6980,488,1,6492,6980
1.00E+12,310,397,10,3980,397,1,3583,3980
2.10E+12,310,297,10,2980,891,3,8049,8940
8090941,310,476,10,4780,476,1,4304,4780
8233374,310,347,10,3480,347,1,3133,3480
1.00E+12,240,1340,50,2680,21440,16,21440,42880
1.00E+12,100,3022,9.7,31000,3022,1,27978,31000
1.00E+12,310,190,16.1,1180,950,5,4950,5900
1.00E+12,310,198,10,1980,396,2,3564,3960
1.00E+12,310,238,10,2380,238,1,2142,2380
9035832,310,4207,53.2,7900,8413,2,7387,15800
2.10E+12,310,955,6.6,14550,955,1,13595,14550
1.00E+12,310,102,6.5,1580,307,3,4433,4740
1.00E+12,310,2370,12.5,18900,4740,2,33060,37800
8764265,310,138,7,1980,276,2,3684,3960
8228112,310,2437,55,4430,24365,10,19935,44300
1.00E+12,310,98,10,980,1078,11,9702,10780
8228112,511,2437,55,4430,24365,10,19935,44300
2.10E+12,200,1000,20.1,4980,6000,6,23880,29880
7242787,310,194,5,3880,2910,15,55290,58200
1.00E+12,310,83,9.4,890,1001,12,9679,10680
1.00E+12,310,201,9.2,2180,201,1,1979,2180
1.00E+12,310,610,9.2,6600,610,1,5990,6600
1.00E+12,205,4082,28.7,14200,4082,1,10118,14200
1.00E+12,310,4782,9.9,48500,4782,1,43718,48500
9659362,310,5198,52.5,9900,20790,4,18810,39600
1.00E+12,511,5408,52.5,10300,10815,2,9785,20600
7104921,240,1863,33.3,5590,5588,3,11182,16770
1.00E+12,310,488,10,4880,2928,6,26352,29280
1.00E+12,310,411,9.6,4280,411,1,3869,4280
1.00E+12,310,1766,14.1,12500,1766,1,10734,12500
1.00E+12,200,1681,14.1,11900,1681,1,10219,11900
1.00E+12,200,14950,5,299000,14950,1,284050,299000
1.00E+12,200,3600,12,30000,3600,1,26400,30000
2.10E+12,310,100,6.7,1500,10000,100,140000,150000
1.00E+12,100,295,5,5900,295,1,5605,5900
1.00E+12,310,64,5,1280,320,5,6080,6400
1.00E+12,310,79,5,1580,474,6,9006,9480
1.00E+12,310,1452,8.8,16500,2904,2,30096,33000
1.00E+12,310,698,10,6980,1396,2,12564,13960
2.10E+12,601,919,30.8,2980,1837,2,4123,5960
2.10E+12,310,7229,36.2,19980,7229,1,12751,19980
2.10E+12,310,919,30.8,2980,1837,2,4123,5960
2.10E+12,205,4667,36.2,12900,4667,1,8233,12900
1.00E+12,310,558,7,7980,1116,2,14844,15960
1.00E+12,310,7903,26.3,30000,15806,2,44194,60000
1.00E+12,200,10557,6.9,153000,10557,1,142443,153000
2.10E+12,310,1132,7,16180,1132,1,15048,16180
2.10E+12,200,2637,16.3,16180,2637,1,13543,16180
1.00E+12,200,5050,20.2,25000,5050,1,19950,25000
2.10E+12,310,349,5,6980,349,1,6631,6980
1.00E+12,310,1118,10,11180,4472,4,40248,44720
1.00E+12,310,418,7,5980,1254,3,16686,17940
1.00E+12,310,558,7,7980,6696,12,89064,95760
1.00E+12,500,3510,17.6,20000,3510,1,16490,20000
1.00E+12,240,298,10,2980,5662,19,50958,56620
1.00E+12,240,1096,20,5480,1096,1,4384,5480
1.00E+12,310,2980,20,14900,2980,1,11920,14900
1.00E+12,310,1145,5,22900,1145,1,21755,22900
4867402,300,6670,14.5,46000,13340,2,78660,92000
7936136,310,488,7,6980,976,2,12984,13960
1.00E+12,310,1258,7,17980,2516,2,33444,35960
1.00E+12,310,558,7,7980,1674,3,22266,23940
1.00E+12,310,316,6.3,4980,316,1,4664,4980
1.00E+12,310,660,11,5980,660,1,5320,5980
1.00E+12,310,443,6.3,6980,443,1,6537,6980
1.00E+12,310,251,6.4,3950,251,1,3699,3950
2.10E+12,310,2844,24,11850,14220,5,45030,59250
6869928,310,728,10,7280,728,1,6552,7280
2.10E+12,310,1580,23.2,6800,9480,6,31320,40800
1.00E+12,310,1590,10,15900,1590,1,14310,15900
1.00E+12,310,198,10,1980,198,1,1782,1980
1.00E+12,310,144,9.1,1580,719,5,7181,7900
8044443,310,100,10,1000,1200,12,10800,12000
1.00E+12,310,590,10,5900,1180,2,10620,11800
8333610,340,294,7,4200,1176,4,15624,16800
6615198,340,103,7,1480,206,2,2754,2960
10614227,310,250,7,3580,750,3,9990,10740
1.00E+12,310,483,7,6900,966,2,12834,13800
1.00E+12,310,1752,6.7,25980,1752,1,24228,25980
1.00E+12,310,807,6.7,11980,807,1,11173,11980
1.00E+12,310,376,6.7,5580,376,1,5204,5580
1.00E+12,310,470,6.7,6980,470,1,6510,6980
1.00E+12,310,571,6.7,8480,571,1,7909,8480
1.00E+12,100,59,2,2980,59,1,2921,2980
7501565,100,179,2,8980,179,1,8801,8980
2.10E+12,310,596,30.1,1980,596,1,1384,1980
1.00E+12,100,391,6.9,5680,391,1,5289,5680
1.00E+12,100,136,6.9,1980,136,1,1844,1980
7252138,501,87,5,1750,174,2,3326,3500
2.10E+12,501,596,30.1,1980,596,1,1384,1980
2.10E+12,310,215,5,4300,430,2,8170,8600
2.10E+12,310,174,5,3480,174,1,3306,3480
1.00E+12,310,118,10,1180,472,4,4248,4720
1.00E+12,310,3118,22.6,13800,3118,1,10682,13800
7350960,310,1603,40.6,3950,4810,3,7040,11850
2.10E+12,310,162,8.1,2000,162,1,1838,2000
2.10E+12,310,403,8.1,4970,403,1,4567,4970
1.00E+12,240,1338,12.4,10780,2675,2,18885,21560
2.10E+12,205,984,15.2,6480,984,1,5496,6480
7022398,310,438,10,4380,1314,3,11826,13140
7695343,310,840,10,8400,1680,2,15120,16800
8598301,310,118,10,1180,590,5,5310,5900
1.00E+12,310,288,10,2880,288,1,2592,2880
1.00E+12,310,474,5,9480,2844,6,54036,56880
1.00E+12,310,59,5,1180,354,6,6726,7080
6609224,310,106,5,2130,318,3,6072,6390
1.00E+12,310,345,5,6900,690,2,13110,13800
1.00E+12,310,159,7,2280,1908,12,25452,27360
2.10E+12,310,114,5,2280,114,1,2166,2280
7480113,310,85,7,1220,85,1,1135,1220
1.00E+12,310,140,7,2000,140,1,1860,2000
1.00E+12,300,1170,20,5850,2340,2,9360,11700
1.00E+12,310,848,10,8480,3392,4,30528,33920
1.00E+12,310,98,10,980,392,4,3528,3920
6829364,310,2086,28,7450,2086,1,5364,7450
1.00E+12,200,15698,23.5,66800,15698,1,51102,66800
8239927,310,393,9.2,4280,786,2,7774,8560
1.00E+12,310,91,9.2,990,546,6,5394,5940
1.00E+12,310,368,9.2,3980,368,1,3612,3980
1.00E+12,310,1762,9.3,18900,1762,1,17138,18900
6621453,310,368,9.2,3980,368,1,3612,3980
1.00E+12,310,245,9.2,2650,245,1,2405,2650
1.00E+12,310,220,9.2,2380,220,1,2160,2380
1.00E+12,310,322,9.3,3480,322,1,3158,3480
1.00E+12,310,266,9.2,2880,266,1,2614,2880
1.00E+12,310,1362,8.5,15980,1362,1,14618,15980
1.00E+12,300,2500,20,12480,17500,7,69860,87360
1.00E+12,310,156,6.3,2480,156,1,2324,2480
1.00E+12,310,947,6.3,14980,947,1,14033,14980
1.00E+12,310,99,6.3,1580,99,1,1481,1580
1.00E+12,200,450,10,4500,450,1,4050,4500
1.00E+12,601,1840,11.6,15800,1840,1,13960,15800
2.10E+12,310,1491,11.6,12800,1491,1,11309,12800
2.10E+12,310,271,7,3880,1897,7,25263,27160
1.00E+12,310,2346,28,8380,4692,2,12068,16760
1.00E+12,200,2953,4,74400,2953,1,71447,74400
8632217,310,548,10,5480,1096,2,9864,10960
1.00E+12,300,2000,18.2,10980,2000,1,8980,10980
1.00E+12,100,1745,5,34900,1745,1,33155,34900
1.00E+12,240,5871,19,30900,41097,7,175203,216300
1.00E+12,200,960,12,8000,960,1,7040,8000
1.00E+12,310,149,5,2980,298,2,5662,5960
1.00E+12,310,499,5,9980,499,1,9481,9980
1.00E+12,501,286,5,5730,286,1,5444,5730
1.00E+12,310,374,5,7480,1122,3,21318,22440
1.00E+12,310,170,10,1700,170,1,1530,1700
1.00E+12,310,290,10,2900,290,1,2610,2900
1.00E+12,310,799,10,7990,3196,4,28764,31960
1.00E+12,310,298,10,2980,894,3,8046,8940
2.10E+12,310,83,3.3,2480,83,1,2397,2480
2.10E+12,310,171,3.4,5100,171,1,4929,5100
2.10E+12,310,124,3.4,3700,124,1,3576,3700
1.00E+12,310,73,3.3,2180,73,1,2107,2180
2.10E+12,310,333,3.4,9900,333,1,9567,9900
6618823,310,70,3.4,2080,210,3,6030,6240
2.10E+12,310,2262,23.1,9800,2262,1,7538,9800
2.10E+12,310,80,3.4,2380,80,1,2300,2380
2.10E+12,200,2167,31,6980,2167,1,4813,6980
1.00E+12,500,8860,23.3,38000,8860,1,29140,38000
7690580,310,285,10,2850,855,3,7695,8550
1.00E+12,300,7980,20.5,39000,7980,1,31020,39000
1.00E+12,500,44020,27.8,158400,44020,1,114380,158400
1.00E+12,200,13110,27.8,47200,13110,1,34090,47200
1.00E+12,300,13110,27.8,47200,13110,1,34090,47200
1.00E+12,340,5943,7,84900,5943,1,78957,84900
1.00E+12,300,1600,13.8,11580,14400,9,89820,104220
8553755,340,245,7,3500,245,1,3255,3500
1.00E+12,310,668,10,6680,1336,2,12024,13360
8781555,310,1068,10,10680,1068,1,9612,10680
1.00E+12,310,898,10,8980,898,1,8082,8980
1.00E+12,310,348,10,3480,1392,4,12528,13920
1.00E+12,240,1400,20,7000,1400,1,5600,7000
1.00E+12,200,980,10,9800,980,1,8820,9800
1.00E+12,100,352,8.8,3980,352,1,3628,3980
6815936,100,86,8.8,980,172,2,1788,1960
1.00E+12,100,307,8.8,3480,614,2,6346,6960
8568431,501,378,8.8,4280,378,1,3902,4280
6815936,501,86,8.8,980,172,2,1788,1960
1.00E+12,501,440,8.8,4980,440,1,4540,4980
1.00E+12,310,5980,20,29900,5980,1,23920,29900
1.00E+12,200,143980,7.4,1947000,143980,1,1803020,1947000
1.00E+12,200,15710,27.1,58000,15710,1,42290,58000
8486451,100,70,1,7000,70,1,6930,7000
6615248,100,23,1,2300,23,1,2277,2300
2.10E+12,100,378,10.9,3480,378,1,3102,3480
2.10E+12,205,1681,30.7,5480,1681,1,3799,5480
7889763,501,25,1,2580,50,2,5110,5160
2.10E+12,501,29,1,2980,29,1,2951,2980
2.10E+12,501,12,0.9,1280,12,1,1268,1280
7718857,310,54,5,1080,54,1,1026,1080
1.00E+12,200,2476,20,12380,19808,8,79232,99040
2.10E+12,310,695,5,13900,695,1,13205,13900
2.10E+12,310,4826,30.5,15800,14478,3,32922,47400
1.00E+12,310,114,9.5,1200,114,1,1086,1200
9071393,310,446,9.5,4680,446,1,4234,4680
2.10E+12,100,399,5,7980,399,1,7581,7980
1.00E+12,100,299,5,5980,299,1,5681,5980
2.10E+12,200,9190,46,19980,73520,8,86320,159840
2.10E+12,340,9190,46,19980,73520,8,86320,159840
1.00E+12,310,77,7.8,990,77,1,913,990
2.10E+12,310,2087,34.9,5980,25044,12,46716,71760
1.00E+12,100,12180,11.2,109000,12180,1,96820,109000
9913922,200,10050,15,67000,10050,1,56950,67000
6615155,310,198,10,1980,2376,12,21384,23760
1.00E+12,310,348,10,3480,348,1,3132,3480
1.00E+12,205,4500,50,9000,4500,1,4500,9000
1.00E+12,240,250,6.3,3980,250,1,3730,3980
1.00E+12,240,250,6.3,3980,250,1,3730,3980
1.00E+12,240,250,6.3,3980,250,1,3730,3980
10732911,310,186,19,980,930,5,3970,4900
1.00E+12,300,5430,9.9,54800,5430,1,49370,54800
2.10E+12,310,418,7,5980,418,1,5562,5980
1.00E+12,500,1593,10,15930,1593,1,14337,15930
1.00E+12,310,927,4.7,19800,2781,3,56619,59400
8333610,310,392,9.3,4200,392,1,3808,4200
1.00E+12,310,1752,9.3,18880,1752,1,17128,18880
1.00E+12,310,1854,9.3,19980,1854,1,18126,19980
1.00E+12,310,33710,25,135100,67420,2,202780,270200
8227172,310,128,10,1280,384,3,3456,3840
1.00E+12,310,418,7,5980,418,1,5562,5980
2.10E+12,310,821,9.8,8380,821,1,7559,8380
1.00E+12,310,110,10,1100,990,9,8910,9900
1.00E+12,300,42140,28,150500,42140,1,108360,150500
1.00E+12,310,348,7,4980,348,1,4632,4980
1.00E+12,310,387,16.3,2380,387,1,1993,2380
1.00E+12,310,139,5,2790,695,5,13255,13950
1.00E+12,200,2980,10,29800,2980,1,26820,29800
8788893,310,237,5.5,4280,237,1,4043,4280
1.00E+12,310,209,5.5,3780,209,1,3571,3780
1.00E+12,310,93,5.5,1680,466,5,7934,8400
1.00E+12,310,110,5.5,1980,329,3,5611,5940
1.00E+12,300,19794,18.2,109000,19794,1,89206,109000
1.00E+12,500,179558,18,996000,538674,3,2449326,2988000
2.10E+12,310,898,10,8980,898,1,8082,8980
1.00E+12,310,1084,9.1,11900,1084,1,10816,11900
1.00E+12,310,1129,9.1,12400,1129,1,11271,12400
1.00E+12,310,370,9.3,3980,370,1,3610,3980
1.00E+12,310,184,9.3,1980,184,1,1796,1980
7377582,310,203,9.3,2180,203,1,1977,2180
1.00E+12,310,277,9.3,2980,277,1,2703,2980
1.00E+12,310,628,9.3,6750,628,1,6122,6750
1.00E+12,310,277,9.3,2980,277,1,2703,2980
1.00E+12,310,165,9.3,1780,165,1,1615,1780
1.00E+12,310,706,9.3,7580,706,1,6874,7580
7113598,310,175,9.3,1880,350,2,3410,3760
1.00E+12,310,371,9.3,3980,741,2,7219,7960
9655398,310,259,9.3,2780,259,1,2521,2780
7934460,310,751,39.5,1900,4508,6,6892,11400
8531580,310,757,9.5,7980,1514,2,14446,15960
8519792,310,437,7.3,5980,437,1,5543,5980
6609572,310,108,7.3,1480,108,1,1372,1480
1.00E+12,310,73,7.3,1000,73,1,927,1000
1.00E+12,310,475,7.3,6500,475,1,6025,6500
1.00E+12,310,729,7.3,9980,729,1,9251,9980
1.00E+12,310,11542,23.3,49600,11542,1,38058,49600
2.10E+12,310,768,7,10980,768,1,10212,10980
2.10E+12,100,504,11.8,4280,504,1,3776,4280
1.00E+12,310,418,7,5980,418,1,5562,5980
8609842,511,410,38,1080,1230,3,2010,3240
1.00E+12,200,23850,15,159000,23850,1,135150,159000
1.00E+12,200,2160,20,10800,2160,1,8640,10800
1.00E+12,200,5390,11,49000,5390,1,43610,49000
2.10E+12,310,1074,10.8,9980,2147,2,17813,19960
1.00E+12,100,535,10.7,4980,1606,3,13334,14940
6616270,100,667,10.8,6200,667,1,5533,6200
2.10E+12,501,3521,22.3,15800,3521,1,12279,15800
1.00E+12,501,58,8.9,650,116,2,1184,1300
2.10E+12,501,751,10.8,6980,1501,2,12459,13960
2.10E+12,501,1392,10.8,12900,2783,2,23017,25800
1.00E+12,310,1369,34.4,3980,1369,1,2611,3980
2.10E+12,205,2096,38.2,5480,2096,1,3384,5480
2.10E+12,310,3945,30.4,12980,3945,1,9035,12980
8525211,310,617,7.2,8580,617,1,7963,8580
2.10E+12,310,561,7.2,7800,561,1,7239,7800
1.00E+12,310,286,7.2,3980,286,1,3694,3980
1.00E+12,200,105850,14.5,730000,105850,1,624150,730000
1.00E+12,200,4500,10,45000,27000,6,243000,270000
7242787,310,452,11.6,3880,452,1,3428,3880
7242787,601,452,11.6,3880,452,1,3428,3880
1.00E+12,100,827,5.9,13900,827,1,13073,13900
1.00E+12,310,5445,55,9900,10890,2,8910,19800
1.00E+12,310,328,10,3280,328,1,2952,3280
1.00E+12,200,6650,19,35000,6650,1,28350,35000
1.00E+12,500,5160,17.2,30000,15480,3,74520,90000
7086322,310,68,10,680,884,13,7956,8840
1.00E+12,310,775,10,7750,775,1,6975,7750
1.00E+12,500,8894,18.7,47600,8894,1,38706,47600
1.00E+12,501,2598,26.2,9900,2598,1,7302,9900
1.00E+12,601,11252,37.6,29900,11252,1,18648,29900
2.10E+12,200,13662,34.6,39500,13662,1,25838,39500
1.00E+12,100,11252,37.6,29900,11252,1,18648,29900
1.00E+12,310,433,10.9,3980,433,1,3547,3980
2.10E+12,100,269,10.8,2480,269,1,2211,2480
1.00E+12,340,901,18.1,4980,901,1,4079,4980
1.00E+12,501,1976,19.8,9980,1976,1,8004,9980
1.00E+12,200,12000,20,60000,48000,4,192000,240000
1.00E+12,310,224,5,4480,448,2,8512,8960
2.10E+12,340,1176,7,16800,3528,3,46872,50400
1.00E+12,310,152,7,2180,608,4,8112,8720
1.00E+12,200,990,5,19900,1980,2,37820,39800
1.00E+12,200,1380,10,13800,1380,1,12420,13800
2.10E+12,310,644,7,9200,1288,2,17112,18400
2.10E+12,310,280,7,4000,560,2,7440,8000
1.00E+12,200,520,1.9,26900,520,1,26380,26900
1.00E+12,340,30208,25.6,118000,30208,1,87792,118000
1.00E+12,200,1390,10,13900,1390,1,12510,13900
1.00E+12,200,3880,11.1,35000,3880,1,31120,35000
8650412,511,2408,53.5,4500,4815,2,4185,9000
1.00E+12,310,122,7,1750,122,1,1628,1750
7531299,310,292,7,4180,292,1,3888,4180
1.00E+12,500,1000,4.1,24500,7000,7,164500,171500
1.00E+12,310,374,7,5350,374,1,4976,5350
1.00E+12,310,558,7,7980,558,1,7422,7980
1.00E+12,200,2110,11.1,19000,2110,1,16890,19000
1.00E+12,310,49,4.9,990,98,2,1882,1980
1.00E+12,200,350,2.2,15900,350,1,15550,15900
1.00E+12,601,84,5,1680,84,1,1596,1680
1.00E+12,200,690,5,13930,690,1,13240,13930
1.00E+12,200,13178,23.8,55300,13178,1,42122,55300
1.00E+12,500,13178,23.8,55300,13178,1,42122,55300
8781553,310,765,9,8480,765,1,7715,8480
1.00E+12,310,1126,9,12480,1126,1,11354,12480
1.00E+12,200,4562,15.8,28900,4562,1,24338,28900
1.00E+12,500,2590,9.7,26730,41440,16,386240,427680
1.00E+12,310,498,10,4980,996,2,8964,9960
2.10E+12,310,398,10,3980,1194,3,10746,11940
1.00E+12,340,24,6.9,348,48,2,648,696
1.00E+12,310,650,10,6500,650,1,5850,6500
2.10E+12,310,378,10,3780,378,1,3402,3780
2.10E+12,310,598,10,5980,1196,2,10764,11960
8986888,310,363,8.1,4500,363,1,4137,4500
1.00E+12,310,10442,17.7,59000,10442,1,48558,59000
1.00E+12,200,10442,17.7,59000,10442,1,48558,59000
1.00E+12,310,324,5,6480,324,1,6156,6480
8225168,310,448,10,4480,4480,10,40320,44800
2.10E+12,310,74,5,1480,148,2,2812,2960
8605224,240,1721,38.2,4500,1721,1,2779,4500
2.10E+12,200,1027,24,4280,1027,1,3253,4280
1.00E+12,200,5850,13,45000,5850,1,39150,45000
10009099,310,523,7,7480,1046,2,13914,14960
1.00E+12,310,225,10,2250,450,2,4050,4500
6617477,310,420,16.3,2580,1260,3,6480,7740
6609402,100,1463,16.3,8980,1463,1,7517,8980
2.10E+12,100,2259,41.2,5480,2259,1,3221,5480
1.00E+12,100,784,24.7,3180,1568,2,4792,6360
1.00E+12,200,1995,5,39900,1995,1,37905,39900
1.00E+12,310,330,9.3,3550,1320,4,12880,14200
1.00E+12,310,2670,10,26700,2670,1,24030,26700
1.00E+12,511,170,16.7,1020,2040,12,10200,12240
1.00E+12,310,182,9.2,1980,182,1,1798,1980
1.00E+12,310,522,9.2,5680,522,1,5158,5680
1.00E+12,310,1084,13.7,7900,1084,1,6816,7900
8333613,310,528,13.7,3850,528,1,3322,3850
1.00E+12,500,6517,19,34300,6517,1,27783,34300
1.00E+12,310,463,5.2,8980,463,1,8517,8980
2.10E+12,310,61,5.1,1180,121,2,2239,2360
1.00E+12,310,122,5.1,2380,122,1,2258,2380
6617477,310,133,5.2,2580,133,1,2447,2580
2.10E+12,200,7819,19.2,40800,7819,1,32981,40800
1.00E+12,200,9345,15,62300,9345,1,52955,62300
1.00E+12,310,57,4.8,1200,57,1,1143,1200
1.00E+12,310,181,4.8,3780,181,1,3599,3780
1.00E+12,205,1194,30,3980,2388,2,5572,7960
1.00E+12,601,475,14.5,3280,950,2,5610,6560
1.00E+12,310,998,10,9980,998,1,8982,9980
1.00E+12,310,4163,18.2,22900,4163,1,18737,22900
2.10E+12,310,170,9,1880,170,1,1710,1880
1.00E+12,310,6074,9.2,65900,6074,1,59826,65900
1.00E+12,200,6384,18.3,34900,6384,1,28516,34900
1.00E+12,300,3384,12.6,26900,6768,2,47032,53800
1.00E+12,200,12675,9.8,130000,12675,1,117325,130000
1.00E+12,200,4425,15,29500,4425,1,25075,29500
1.00E+12,601,311,10.4,2980,311,1,2669,2980
1.00E+12,310,458,5.7,7980,458,1,7522,7980
2.10E+12,310,77,5,1550,77,1,1473,1550
1.00E+12,310,900,10,9000,5400,6,48600,54000
2.10E+12,200,1570,16.9,9300,1570,1,7730,9300
1.00E+12,310,458,10,4580,3664,8,32976,36640
1.00E+12,310,869,8.7,9980,869,1,9111,9980
7936333,240,698,10,6980,2094,3,18846,20940
1.00E+12,310,6389,16.3,39200,6389,1,32811,39200
1.00E+12,340,628,7,8980,628,1,8352,8980
1.00E+12,310,191,5,3830,191,1,3639,3830
8531580,310,558,7,7980,2232,4,29688,31920
3590134,200,525,5,10500,525,1,9975,10500
7454027,100,19,1,1980,19,1,1961,1980
6615474,501,25,1,2560,25,1,2535,2560
8049153,310,68,6.9,980,136,2,1824,1960
8980265,310,68,6.9,980,136,2,1824,1960
1.00E+12,310,68,6.9,980,136,2,1824,1960
9071393,310,468,10,4680,2808,6,25272,28080
1.00E+12,310,1980,40,4950,5940,3,8910,14850
6609993,100,124,10,1240,124,1,1116,1240
1.00E+12,200,20000,11.8,169000,80000,4,596000,676000
,,,,,,,,
1.00E+12,200,1160,5.5,21000,1160,1,19840,21000
6609254,310,618,10,6180,1854,3,16686,18540
1.00E+12,200,960,4.4,21800,960,1,20840,21800
1.00E+12,200,822,23.5,3500,822,1,2678,3500
1.00E+12,601,958,13.9,6900,958,1,5942,6900
6609545,310,241,9.3,2580,241,1,2339,2580
7277969,310,390,10,3900,390,1,3510,3900
1.00E+12,310,149,5,2980,298,2,5662,5960
8236115,100,264,5,5280,264,1,5016,5280
1.00E+12,240,7485,75,9980,59880,8,19960,79840
2.10E+12,310,104,7.5,1380,104,1,1276,1380
9067456,310,119,7.5,1580,119,1,1461,1580
7021920,100,159,16.2,980,4929,31,25451,30380
1.00E+12,310,7630,21.7,35100,7630,1,27470,35100
1.00E+12,310,4427,11.7,38000,4427,1,33573,38000
1.00E+12,310,348,7,4980,8352,24,111168,119520
1.00E+12,310,490,10,4900,1470,3,13230,14700
8117916,310,278,10,2780,834,3,7506,8340
7695322,310,358,10,3580,716,2,6444,7160
6613875,310,348,10,3480,348,1,3132,3480
1.00E+12,310,990,10,9900,3960,4,35640,39600
1.00E+12,200,7546,14,53900,15092,2,92708,107800
1.00E+12,310,1153,7,16480,1153,1,15327,16480
9669780,310,411,7,5880,1233,3,16407,17640
1.00E+12,310,898,10,8980,2694,3,24246,26940
1.00E+12,310,380,10,3800,760,2,6840,7600
1.00E+12,100,974,16.3,5980,974,1,5006,5980
7291156,100,534,16.3,3280,534,1,2746,3280
1.00E+12,310,51,5.2,990,51,1,939,990
2.10E+12,200,1806,24.2,7475,1806,1,5669,7475
1.00E+12,300,245,1,24500,245,1,24255,24500
8039456,310,103,7,1480,412,4,5508,5920
1.00E+12,310,203,7,2900,203,1,2697,2900
1.00E+12,200,9600,20,48000,9600,1,38400,48000
1.00E+12,200,7200,24,30000,7200,1,22800,30000
2.10E+12,100,5615,40.4,13900,5615,1,8285,13900
2.10E+12,100,946,14.5,6530,946,1,5584,6530
2.10E+12,100,3743,31.6,11850,7486,2,16214,23700
2.10E+12,100,8431,44.4,18980,8431,1,10549,18980
7117350,601,134,5,2680,402,3,7638,8040
9751187,310,328,10,3280,984,3,8856,9840
1.00E+12,200,1700,10,17000,1700,1,15300,17000
1.00E+12,310,410,38,1080,2460,6,4020,6480
8069282,310,295,11.8,2500,590,2,4410,5000
1.00E+12,100,882,11.8,7480,882,1,6598,7480
7883482,100,824,11.8,6990,824,1,6166,6990
6612114,501,1767,11.8,14980,1767,1,13213,14980
1.00E+12,501,298,10,2980,298,1,2682,2980
1.00E+12,310,785,9.8,7980,5496,7,50364,55860
1.00E+12,310,1380,9.9,13980,1380,1,12600,13980
2.10E+12,310,943,43.3,2180,5658,6,7422,13080
2.10E+12,310,1918,28,6850,1918,1,4932,6850
2.10E+12,240,943,43.3,2180,5658,6,7422,13080
7693530,310,398,10,3980,796,2,7164,7960
1.00E+12,310,124,5,2480,124,1,2356,2480
1.00E+12,200,6531,15.2,43000,6531,1,36469,43000
1.00E+12,310,399,7,5700,399,1,5301,5700
1.00E+12,500,7477,25.8,29000,7477,1,21523,29000
1.00E+12,310,138,7,1980,138,1,1842,1980
8646828,310,744,7.5,9980,744,1,9236,9980
1.00E+12,310,595,7.5,7980,595,1,7385,7980
8930184,100,59,1,5980,59,1,5921,5980
7377582,501,21,1,2180,21,1,2159,2180
7409863,501,34,1,3480,136,4,13784,13920
1.00E+12,310,1098,10,10980,7686,7,69174,76860
1.00E+12,310,398,10,3980,398,1,3582,3980
6617166,310,138,7,1980,1794,13,23946,25740
1.00E+12,310,264,7,3780,264,1,3516,3780
1.00E+12,310,288,11.6,2480,288,1,2192,2480
1.00E+12,100,1597,16.3,9800,1597,1,8203,9800
6615122,310,446,7,6380,892,2,11868,12760
1.00E+12,200,8700,15,58000,8700,1,49300,58000
1.00E+12,310,328,10,3280,328,1,2952,3280
1.00E+12,200,616,8,7700,616,1,7084,7700
6610012,310,710,5,14200,710,1,13490,14200
1.00E+12,310,4416,29.4,15000,4416,1,10584,15000
1.00E+12,200,4416,29.4,15000,4416,1,10584,15000
672170,310,24700,11.8,210000,49400,2,370600,420000
1.00E+12,310,251,9.7,2580,251,1,2329,2580
1.00E+12,310,145,5,2900,725,5,13775,14500
1.00E+12,310,890,10,8900,3560,4,32040,35600
6609408,310,398,10,3980,3184,8,28656,31840
7332561,310,198,10,1980,594,3,5346,5940
1.00E+12,310,69,7,990,69,1,921,990
8279126,310,159,7,2280,1431,9,19089,20520
10631374,300,1420,20,7100,7100,5,28400,35500
1.00E+12,310,507,6.5,7780,507,1,7273,7780
1.00E+12,310,161,7,2300,161,1,2139,2300
1.00E+12,310,315,7,4500,630,2,8370,9000
6609254,310,432,7,6180,864,2,11496,12360
2.10E+12,200,519,20.9,2480,1038,2,3922,4960
1.00E+12,310,238,10,2380,476,2,4284,4760
1.00E+12,310,451,6.7,6700,451,1,6249,6700
1.00E+12,310,330,6.7,4900,330,1,4570,4900
1.00E+12,310,509,6.7,7560,509,1,7051,7560
1.00E+12,310,380,10,3800,380,1,3420,3800
1.00E+12,240,334,3.1,10780,667,2,20893,21560
1.00E+12,340,84,7,1200,84,1,1116,1200
8333411,340,66,6.9,950,132,2,1768,1900
1.00E+12,310,158,10,1580,948,6,8532,9480
1.00E+12,310,158,10,1580,158,1,1422,1580
1.00E+12,310,398,10,3980,1592,4,14328,15920
1.00E+12,310,1198,10,11980,1198,1,10782,11980
1.00E+12,310,429,8.6,4980,429,1,4551,4980
1.00E+12,240,492,16.5,2980,984,2,4976,5960
1.00E+12,310,337,9.2,3680,674,2,6686,7360
2.10E+12,310,418,10,4180,2090,5,18810,20900
1.00E+12,500,27410,27.9,98100,27410,1,70690,98100
1.00E+12,310,258,10,2580,1548,6,13932,15480
1.00E+12,310,1498,10,14980,1498,1,13482,14980
1.00E+12,310,2298,10,22980,2298,1,20682,22980
1.00E+12,310,418,7,5980,836,2,11124,11960
1.00E+12,310,555,7,7940,555,1,7385,7940
1.00E+12,310,1320,14.2,9300,1320,1,7980,9300
8023182,310,400,10,4000,2000,5,18000,20000
1.00E+12,300,3000,17.7,16980,3000,1,13980,16980
1.00E+12,300,3000,17.7,16980,6000,2,27960,33960
1.00E+12,310,1255,7.9,15980,1255,1,14725,15980
1.00E+12,310,1494,7.9,18980,2988,2,34972,37960
1.00E+12,310,222,7,3180,1998,9,26622,28620
1.00E+12,310,418,7,5980,1254,3,16686,17940
1.00E+12,310,213,7.9,2680,213,1,2467,2680
1.00E+12,310,197,7.9,2480,197,1,2283,2480
1.00E+12,310,157,7.9,1980,157,1,1823,1980
1.00E+12,310,332,7.9,4180,332,1,3848,4180
1.00E+12,100,417,14.5,2880,417,1,2463,2880
8117980,100,420,14.5,2900,420,1,2480,2900
1.00E+12,310,358,9.7,3680,358,1,3322,3680
1.00E+12,310,11717,9.4,125000,11717,1,113283,125000
1.00E+12,200,6487,18.9,34300,6487,1,27813,34300
1.00E+12,310,1298,10,12980,2596,2,23364,25960
6621656,310,290,10,2900,580,2,5220,5800
1.00E+12,310,1358,10,13580,1358,1,12222,13580
1.00E+12,310,698,10,6980,698,1,6282,6980
1.00E+12,310,768,7,10980,768,1,10212,10980
1.00E+12,200,19691,22.1,89100,19691,1,69409,89100
1.00E+12,200,80,20,400,3600,45,14400,18000
1.00E+12,200,82,20,410,10168,124,40672,50840
1.00E+12,310,278,7,3980,1112,4,14808,15920
1.00E+12,310,2793,10,27930,2793,1,25137,27930
7408194,310,199,5,3980,398,2,7562,7960
1.00E+12,310,411,4.2,9880,411,1,9469,9880
2.10E+12,310,203,7,2900,406,2,5394,5800
1.00E+12,310,149,5,2980,149,1,2831,2980
2.10E+12,100,179,5,3580,179,1,3401,3580
8210715,100,174,5,3480,174,1,3306,3480
1.00E+12,310,875,5,17500,1750,2,33250,35000
6819645,310,903,7,12900,3612,4,47988,51600
1.00E+12,240,1000,14.3,7000,3000,3,18000,21000
7299217,310,763,7,10900,1526,2,20274,21800
8456661,310,119,7,1700,833,7,11067,11900
7073178,310,682,7,9750,682,1,9068,9750
7890663,310,198,10,1980,1782,9,16038,17820
6845378,310,178,10,1780,1246,7,11214,12460
6609430,310,157,7,2250,1099,7,14651,15750
2.10E+12,310,404,7,5780,404,1,5376,5780
1.00E+12,200,590,5,11800,590,1,11210,11800
1.00E+12,310,595,10,5950,595,1,5355,5950
1.00E+12,200,9900,20,49500,9900,1,39600,49500
1.00E+12,310,222,7,3180,666,3,8874,9540
1.00E+12,200,1601,15.4,10400,1601,1,8799,10400
1.00E+12,200,1339,15.4,8700,1339,1,7361,8700
7648614,310,95,10,950,2185,23,19665,21850
25342,300,10010,23.3,43000,20020,2,65980,86000
1.00E+12,200,8650,16.3,53100,8650,1,44450,53100
1.00E+12,300,12620,26.6,47400,12620,1,34780,47400
1.00E+12,300,7720,14.3,54000,7720,1,46280,54000
1.00E+12,240,1705,40.6,4200,1705,1,2495,4200
2.10E+12,310,324,10.9,2980,972,3,7968,8940
2.10E+12,310,574,10.9,5280,574,1,4706,5280
2.10E+12,100,411,10.9,3780,411,1,3369,3780
1.00E+12,100,141,10.8,1300,282,2,2318,2600
1.00E+12,501,1705,40.6,4200,1705,1,2495,4200
1.00E+12,501,978,10.9,8980,978,1,8002,8980
9054187,501,302,10.9,2780,302,1,2478,2780
1.00E+12,200,1480,14.9,9900,1480,1,8420,9900
7586016,310,1141,7.9,14400,2282,2,26518,28800
2.10E+12,310,299,7.9,3780,299,1,3481,3780
7586016,100,1141,7.9,14400,2282,2,26518,28800
1.00E+12,100,195,7.9,2480,195,1,2285,2480
1.00E+12,501,195,7.9,2480,195,1,2285,2480
2.10E+12,501,838,7,11980,838,1,11142,11980
7452329,310,428,10,4280,5992,14,53928,59920
1.00E+12,310,158,10,1580,316,2,2844,3160
843362,200,62400,12,520000,62400,1,457600,520000
1.00E+12,310,526,14.5,3630,526,1,3104,3630
1.00E+12,310,261,9.7,2680,261,1,2419,2680
1.00E+12,310,3697,14.5,25500,3697,1,21803,25500
1.00E+12,310,1244,14.5,8580,1244,1,7336,8580
1.00E+12,310,193,9.7,1980,193,1,1787,1980
1.00E+12,100,475,9.7,4880,475,1,4405,4880
1.00E+12,310,14820,19,78000,14820,1,63180,78000
1.00E+12,200,14820,19,78000,14820,1,63180,78000
1.00E+12,240,2601,51,5100,13005,5,12495,25500
1.00E+12,205,2148,26.9,7980,8592,4,23328,31920
1.00E+12,200,12954,12.7,102000,12954,1,89046,102000
1.00E+12,310,4455,36.2,12300,4455,1,7845,12300
1.00E+12,310,1057,7.6,13980,1057,1,12923,13980
1.00E+12,310,720,24,3000,720,1,2280,3000
2.10E+12,240,2164,36.2,5980,4328,2,7632,11960
1.00E+12,310,440,8.8,4980,440,1,4540,4980
1.00E+12,100,440,8.8,4980,440,1,4540,4980
1.00E+12,310,5275,8.1,64800,5275,1,59525,64800
6616801,310,298,10,2980,1788,6,16092,17880
1.00E+12,310,2320,14.5,16000,2320,1,13680,16000
8077036,310,395,10,3950,395,1,3555,3950
1.00E+12,100,1474,55,2680,10318,7,8442,18760
1.00E+12,100,1295,37,3500,5180,4,8820,14000
1.00E+12,310,625,5,12500,625,1,11875,12500
1.00E+12,200,4790,16,29900,4790,1,25110,29900
1.00E+12,240,1440,30,4800,11520,8,26880,38400
1.00E+12,310,823,11.8,6980,823,1,6157,6980
1.00E+12,310,377,11.8,3200,377,1,2823,3200
1.00E+12,100,377,11.8,3200,377,1,2823,3200
1.00E+12,501,587,11.8,4980,587,1,4393,4980
1.00E+12,310,120,10,1200,240,2,2160,2400
1.00E+12,310,108,10,1080,216,2,1944,2160
6609257,310,190,19,1000,1900,10,8100,10000
6610261,310,1400,35.2,3980,1400,1,2580,3980
1.00E+12,100,1012,14.5,6980,3036,3,17904,20940
1.00E+12,100,359,14.5,2480,2154,6,12726,14880
1.00E+12,310,693,9.9,6980,693,1,6287,6980
1.00E+12,310,256,9.9,2580,256,1,2324,2580
1.00E+12,310,454,9.9,4580,454,1,4126,4580
1.00E+12,300,14507,16.3,89000,14507,1,74493,89000
1.00E+12,500,2880,10,28800,2880,1,25920,28800
1.00E+12,601,299,5,5980,299,1,5681,5980
1.00E+12,601,299,5,5980,299,1,5681,5980
7150066,310,428,10,4280,428,1,3852,4280
1.00E+12,310,429,9.6,4480,429,1,4051,4480
1.00E+12,310,151,9.6,1580,151,1,1429,1580
8049148,310,94,9.6,980,94,1,886,980
1.00E+12,310,276,9.6,2880,276,1,2604,2880
7695649,310,95,9.6,990,285,3,2685,2970
1.00E+12,310,381,9.6,3980,381,1,3599,3980
1.00E+12,310,3550,9.6,36900,3550,1,33350,36900
1.00E+12,310,199,5,3980,995,5,18905,19900
1.00E+12,601,967,27.8,3480,967,1,2513,3480
1.00E+12,310,3190,14.5,22000,3190,1,18810,22000
1.00E+12,310,2340,9.8,24000,2340,1,21660,24000
,,,,,,,,
2.10E+12,310,264,7,3780,1056,4,14064,15120
1.00E+12,310,151,9,1680,151,1,1529,1680
2.10E+12,200,718,36.3,1980,718,1,1262,1980
1.00E+12,310,2950,5,59000,2950,1,56050,59000
1.00E+12,200,1120,10,11200,1120,1,10080,11200
1.00E+12,200,595,10,5950,595,1,5355,5950
2.10E+12,310,1886,19.2,9800,9430,5,39570,49000
1.00E+12,310,214,5,4280,428,2,8132,8560
6609113,310,285,9.6,2980,285,1,2695,2980
8531580,310,763,9.6,7980,763,1,7217,7980
1.00E+12,200,12840,6,214000,12840,1,201160,214000
1.00E+12,200,990,10,9900,1980,2,17820,19800
,,,,,,,,
1.00E+12,310,888,10,8880,1776,2,15984,17760
8123202,310,68,6.9,980,136,2,1824,1960
1.00E+12,300,177624,24.7,720000,177624,1,542376,720000
1.00E+12,200,5600,20,28000,5600,1,22400,28000
1.00E+12,310,350,5,7000,700,2,13300,14000
7672295,310,339,5,6780,339,1,6441,6780
1.00E+12,310,84,5,1680,336,4,6384,6720
1.00E+12,200,2540,23.1,11000,2540,1,8460,11000
9077258,511,1434,53.5,2680,17202,12,14958,32160
2.10E+12,310,432,14.5,2980,432,1,2548,2980
2.10E+12,310,205,7.4,2780,205,1,2575,2780
1.00E+12,310,8223,9.8,84000,8223,1,75777,84000
10008971,310,267,10,2680,267,1,2413,2680
1.00E+12,310,1862,53.5,3480,18615,10,16185,34800
1.00E+12,310,68,10,680,1224,18,11016,12240
1.00E+12,200,1274,13,9800,2548,2,17052,19600
1.00E+12,310,392,7.9,4980,392,1,4588,4980
1.00E+12,100,2737,11.6,23500,2737,1,20763,23500
1.00E+12,200,4650,15,31000,4650,1,26350,31000
8609842,511,270,25,1080,1080,4,3240,4320
1.00E+12,310,932,11.7,7980,932,1,7048,7980
1.00E+12,310,184,11.6,1580,184,1,1396,1580
1.00E+12,310,897,9,9980,897,1,9083,9980
1.00E+12,310,1167,9,12980,1167,1,11813,12980
1.00E+12,310,278,7,3980,834,3,11106,11940
1.00E+12,310,693,7,9900,2079,3,27621,29700
1.00E+12,310,173,7,2480,346,2,4614,4960
2.10E+12,200,1954,28,6980,21494,11,55286,76780
1.00E+12,310,236,18.2,1300,236,1,1064,1300
1.00E+12,310,418,7,5980,836,2,11124,11960
6609062,310,70,7,1000,140,2,1860,2000
8694843,310,348,7,4980,696,2,9264,9960
9700874,310,69,7,990,414,6,5526,5940
1.00E+12,310,199,5,3980,199,1,3781,3980
6994628,310,110,9.3,1180,110,1,1070,1180
1.00E+12,310,204,9.4,2180,204,1,1976,2180
1.00E+12,200,6031,16.3,37000,6031,1,30969,37000
1.00E+12,310,143,9.9,1450,572,4,5228,5800
1.00E+12,310,143,9.9,1450,572,4,5228,5800
8917703,310,543,9.1,5980,543,1,5437,5980
1.00E+12,310,658,10,6580,1316,2,11844,13160
1.00E+12,310,398,10,3980,398,1,3582,3980
1.00E+12,300,2000,11.8,16980,2000,1,14980,16980
10354256,310,227,10,2280,227,1,2053,2280
1.00E+12,200,470,5,9400,470,1,8930,9400
,,,,,,,,
7021920,100,186,19,980,1116,6,4764,5880
6622420,100,572,14.5,3950,1144,2,6756,7900
1.00E+12,100,168,5,3360,168,1,3192,3360
1.00E+12,100,1075,5,21500,1075,1,20425,21500
1.00E+12,200,10500,15,70000,31500,3,178500,210000
1.00E+12,340,203,7,2900,1015,5,13485,14500
7303499,340,278,7,3980,278,1,3702,3980
1.00E+12,200,3500,10,35000,7000,2,63000,70000
8460776,310,488,7,6980,1464,3,19476,20940
7548968,310,199,7,2850,398,2,5302,5700
1.00E+12,200,4230,10,42300,4230,1,38070,42300
1.00E+12,200,970,5,19500,1940,2,37060,39000
7095585,310,407,8.2,4980,407,1,4573,4980
8886936,310,235,8.2,2880,235,1,2645,2880
8228112,310,2396,54.1,4430,4792,2,4068,8860
8309816,310,96,8.1,1180,96,1,1084,1180
1.00E+12,240,5588,56.4,9900,22353,4,17247,39600
10039403,310,748,10,7480,748,1,6732,7480
1.00E+12,500,1520,5,30500,1520,1,28980,30500
1.00E+12,310,398,10,3980,398,1,3582,3980
9017971,310,748,10,7480,2244,3,20196,22440
7587257,310,65,10,650,130,2,1170,1300
7934460,511,760,40,1900,2280,3,3420,5700
1.00E+12,310,1090,10,10900,2180,2,19620,21800
1.00E+12,310,128,10,1280,1536,12,13824,15360
1.00E+12,200,1270,5.5,23000,1270,1,21730,23000
1.00E+12,310,1958,7,27980,5874,3,78066,83940
1.00E+12,310,798,10,7980,1596,2,14364,15960
2.10E+12,310,896,28,3200,896,1,2304,3200
1.00E+12,310,5779,21.4,27000,5779,1,21221,27000
1.00E+12,310,274,5,5480,274,1,5206,5480
1.00E+12,310,572,7,8180,2288,4,30432,32720
1.00E+12,310,429,9.4,4580,429,1,4151,4580
1.00E+12,200,10620,18,59000,10620,1,48380,59000
1.00E+12,240,817,23.5,3480,1634,2,5326,6960
1.00E+12,310,264,8.8,3000,264,1,2736,3000
1.00E+12,200,25482,18.7,136000,25482,1,110518,136000
2.10E+12,310,664,9.5,6980,664,1,6316,6980
10528692,310,843,9.6,8800,843,1,7957,8800
1.00E+12,310,358,9,3980,358,1,3622,3980
1.00E+12,310,268,9,2980,268,1,2712,2980
1.00E+12,200,1190,10,11900,1190,1,10710,11900
1.00E+12,200,6960,15,46400,13920,2,78880,92800
1.00E+12,200,1560,20,7800,1560,1,6240,7800
1.00E+12,200,7130,31,23000,7130,1,15870,23000
1.00E+12,310,299,5,5980,299,1,5681,5980
1.00E+12,100,35,2,1780,35,1,1745,1780
1.00E+12,310,3841,9.9,38980,7681,2,70279,77960
1.00E+12,200,29721,18.8,158000,29721,1,128279,158000
8410642,310,198,10,1980,990,5,8910,9900
2.10E+12,601,836,11.6,7180,836,1,6344,7180
1.00E+12,310,1590,10,15900,1590,1,14310,15900
1.00E+12,200,2300,5,46000,2300,1,43700,46000
1.00E+12,310,3808,42.4,8980,7616,2,10344,17960
8427035,310,492,17.7,2780,492,1,2288,2780
8427035,100,492,17.7,2780,492,1,2288,2780
2.10E+12,100,1313,13.2,9980,1313,1,8667,9980
1.00E+12,310,19008,24,79200,19008,1,60192,79200
1.00E+12,310,1580,14.5,10900,3160,2,18640,21800
7047985,310,298,10,2980,298,1,2682,2980
6608959,310,341,10,3410,1023,3,9207,10230
2.10E+12,310,698,10,6980,2094,3,18846,20940
1.00E+12,310,27025,23.5,115000,27025,1,87975,115000
1.00E+12,310,389,8.5,4580,389,1,4191,4580
1.00E+12,310,236,8.5,2780,236,1,2544,2780
1.00E+12,310,1043,8.5,12280,1043,1,11237,12280
1.00E+12,200,3220,10,32200,3220,1,28980,32200
1.00E+12,200,1590,10,15900,1590,1,14310,15900
1.00E+12,200,10165,25.5,39900,10165,1,29735,39900
1.00E+12,200,930,5,18600,930,1,17670,18600
1.00E+12,310,174,5,3480,348,2,6612,6960
7941128,310,239,5,4780,956,4,18164,19120
1.00E+12,200,14702,25.8,57000,14702,1,42298,57000
1.00E+12,310,67,5.7,1180,67,1,1113,1180
1.00E+12,310,67,5.7,1180,67,1,1113,1180
1.00E+12,310,733,7.4,9900,733,1,9167,9900
1.00E+12,200,469,12,3900,1407,3,10293,11700
7695649,310,111,11.2,990,111,1,879,990
1.00E+12,200,4700,10,47000,4700,1,42300,47000
2.10E+12,310,119,5,2380,119,1,2261,2380
2.10E+12,310,2186,5.8,37980,2186,1,35794,37980
6615248,310,131,5.7,2300,131,1,2169,2300
9005828,310,424,5,8480,424,1,8056,8480
1.00E+12,310,374,5,7480,374,1,7106,7480
1.00E+12,310,499,5,9980,499,1,9481,9980
1.00E+12,310,399,5,7980,798,2,15162,15960
9708613,310,149,5,2980,447,3,8493,8940
9602031,310,399,5,7980,798,2,15162,15960
1.00E+12,310,543,9.7,5580,543,1,5037,5580
1.00E+12,200,830,3,27800,830,1,26970,27800
1.00E+12,500,7970,20.4,39000,7970,1,31030,39000
8834350,310,1264,9.7,12980,1264,1,11716,12980
1.00E+12,310,388,9.7,3980,775,2,7185,7960
7151212,310,55,5,1100,55,1,1045,1100
1.00E+12,200,3480,14.5,24000,3480,1,20520,24000
8606784,310,139,7,1980,139,1,1841,1980
10051441,310,504,16.4,3080,2015,4,10305,12320
1.00E+12,240,732,6.8,10780,732,1,10048,10780
1.00E+12,310,164,5,3280,164,1,3116,3280
1.00E+12,500,20071,20.5,98100,40142,2,156058,196200
1.00E+12,310,194,7,2780,388,2,5172,5560
1.00E+12,300,1000,11.1,8980,3000,3,23940,26940
1.00E+12,310,548,10,5480,1096,2,9864,10960
2.10E+12,310,1380,10,13800,8280,6,74520,82800
1.00E+12,310,418,7,5980,418,1,5562,5980
1.00E+12,511,5756,52.8,10900,11512,2,10288,21800
1.00E+12,310,307,5.6,5480,307,1,5173,5480
1.00E+12,310,347,5.6,6180,347,1,5833,6180
1.00E+12,310,67,5.6,1200,134,2,2266,2400
1.00E+12,310,242,5.6,4320,242,1,4078,4320
1.00E+12,310,251,5.6,4480,251,1,4229,4480
6609119,310,240,5.6,4280,240,1,4040,4280
1.00E+12,310,672,5.6,11980,672,1,11308,11980
1.00E+12,310,998,10,9980,2994,3,26946,29940
1.00E+12,310,698,10,6980,7678,11,69102,76780
8484691,100,45,1,4580,45,1,4535,4580
1.00E+12,100,18,1,1880,36,2,3724,3760
1.00E+12,501,14,1,1400,14,1,1386,1400
1.00E+12,501,17,1,1780,34,2,3526,3560
1.00E+12,200,6296,18.5,34000,6296,1,27704,34000
1.00E+12,310,698,10,6980,8376,12,75384,83760
1.00E+12,310,348,10,3480,696,2,6264,6960
8655012,310,490,10,4900,980,2,8820,9800
2.10E+12,100,2567,28.8,8900,2567,1,6333,8900
8259034,310,273,8.6,3180,273,1,2907,3180
1.00E+12,310,577,14.5,3980,577,1,3403,3980
2.10E+12,310,548,14.5,3780,548,1,3232,3780
1.00E+12,310,1240,10,12400,2480,2,22320,24800
2.10E+12,100,2321,23.7,9800,2321,1,7479,9800
8646395,310,848,10,8480,848,1,7632,8480
8042422,310,149,5,2980,149,1,2831,2980
2.10E+12,310,349,5,6980,349,1,6631,6980
2.10E+12,310,150,8.9,1680,150,1,1530,1680
1.00E+12,310,208,7,2980,416,2,5544,5960
2.10E+12,310,402,8.9,4500,402,1,4098,4500
2.10E+12,310,141,8.9,1580,141,1,1439,1580
2.10E+12,310,2069,16.2,12800,2069,1,10731,12800
1.00E+12,240,573,18,3180,573,1,2607,3180
1.00E+12,240,808,18,4480,808,1,3672,4480
1.00E+12,200,695,5,13900,695,1,13205,13900
1.00E+12,310,495,5,9900,495,1,9405,9900
1.00E+12,601,149,5,2980,149,1,2831,2980
1.00E+12,310,99,5,1980,99,1,1881,1980
1.00E+12,310,199,5,3980,199,1,3781,3980
1.00E+12,310,99,5,1980,99,1,1881,1980
1.00E+12,310,593,7,8480,1186,2,15774,16960
8961033,240,568,14.3,3980,568,1,3412,3980
7561978,310,480,10,4800,480,1,4320,4800
1.00E+12,310,566,19,2980,1698,3,7242,8940
1.00E+12,200,19350,15,129000,19350,1,109650,129000
,,,,,,,,
1.00E+12,200,6225,24.9,25000,6225,1,18775,25000
1.00E+12,310,149,5,2980,149,1,2831,2980
1.00E+12,310,14895,25.2,59000,14895,1,44105,59000
1.00E+12,310,57,6.5,880,574,10,8226,8800
6822821,310,280,9.7,2880,280,1,2600,2880
1.00E+12,310,680,9.7,6980,680,1,6300,6980
1.00E+12,310,124,9.7,1280,372,3,3468,3840
1.00E+12,310,212,9.7,2180,212,1,1968,2180
1.00E+12,310,230,9.3,2480,460,2,4500,4960
6617786,310,139,9.3,1500,139,1,1361,1500
1.00E+12,200,36195,30.2,120000,36195,1,83805,120000
1.00E+12,200,175,17.5,1000,175,1,825,1000
1.00E+12,240,298,10,2980,12218,41,109962,122180
9595783,310,506,5.1,9980,1518,3,28422,29940
1.00E+12,310,228,3.3,6900,228,1,6672,6900
1.00E+12,310,658,3.3,19900,658,1,19242,19900
8596412,310,194,3.3,5880,194,1,5686,5880
1.00E+12,310,721,3.3,21800,721,1,21079,21800
1.00E+12,310,526,3.3,15900,526,1,15374,15900
1.00E+12,310,32,3.3,980,32,1,948,980
1.00E+12,300,1500,11.6,12980,1500,1,11480,12980
8633984,310,7985,55.4,14400,15969,2,12831,28800
1.00E+12,100,266,10.9,2450,266,1,2184,2450
7095585,501,542,10.9,4980,542,1,4438,4980
1.00E+12,501,1473,30.7,4800,1473,1,3327,4800
7647765,310,2880,10,28800,2880,1,25920,28800
2.10E+12,310,5025,39.3,12800,5025,1,7775,12800
8255625,310,173,7,2480,346,2,4614,4960
2.10E+12,601,323,11.6,2780,323,1,2457,2780
8797938,310,178,9,1980,178,1,1802,1980
1.00E+12,310,251,9,2780,501,2,5059,5560
2.10E+12,310,50,9,550,595,12,6005,6600
1.00E+12,310,487,9,5400,487,1,4913,5400
1.00E+12,500,6879,17.5,39200,6879,1,32321,39200
9014178,340,294,7,4200,294,1,3906,4200
1.00E+12,200,196,7,2800,588,3,7812,8400
1.00E+12,310,319,9.7,3280,319,1,2961,3280
8333613,501,77,2,3850,77,1,3773,3850
1.00E+12,100,11533,11.6,99000,11533,1,87467,99000
1.00E+12,200,2390,10,23900,2390,1,21510,23900
1.00E+12,310,451,5.9,7700,451,1,7249,7700
1.00E+12,310,192,5.9,3280,384,2,6176,6560
8593950,310,252,7,3600,756,3,10044,10800
2.10E+12,310,660,8.3,7980,660,1,7320,7980
1.00E+12,310,329,8.3,3980,329,1,3651,3980
2.10E+12,310,262,16.2,1620,262,1,1358,1620
1.00E+12,310,895,5,17900,895,1,17005,17900
1.00E+12,501,5563,15.8,35100,5563,1,29537,35100
1.00E+12,310,99,5,1980,99,1,1881,1980
7216772,310,385,7,5500,385,1,5115,5500
1.00E+12,310,61,6.9,880,3965,65,53235,57200
1.00E+12,310,941,9.4,9980,941,1,9039,9980
1.00E+12,310,453,18.5,2450,905,2,3995,4900
6610267,310,282,9.4,2990,563,2,5417,5980
7626831,310,462,9.4,4900,462,1,4438,4900
2.10E+12,310,2189,55,3980,10945,5,8955,19900
1.00E+12,310,888,10,8880,7992,9,71928,79920
2.10E+12,310,1580,10,15800,3160,2,28440,31600
1.00E+12,500,0,0,31000,0,1,31000,31000
2.10E+12,310,1711,14.5,11800,1711,1,10089,11800
2.10E+12,310,1632,19.2,8480,1632,1,6848,8480
2.10E+12,200,1711,14.5,11800,1711,1,10089,11800
1.00E+12,310,693,7,9900,693,1,9207,9900
1.00E+12,310,576,7,8240,576,1,7664,8240
2.10E+12,100,57,2,2880,114,2,5646,5760
6618841,310,309,5.9,5200,309,1,4891,5200
1.00E+12,501,384,5.9,6480,384,1,6096,6480
1.00E+12,501,1184,5.9,19900,1184,1,18716,19900
1.00E+12,310,2335,9.9,23500,2335,1,21165,23500
1.00E+12,310,2435,14.4,16900,2435,1,14465,16900
1.00E+12,200,1740,37.8,4600,1740,1,2860,4600
1.00E+12,200,5978,37.8,15800,5978,1,9822,15800
1.00E+12,200,3216,37.8,8500,3216,1,5284,8500
1.00E+12,200,2640,6,44000,2640,1,41360,44000
2.10E+12,205,1770,30,5900,1770,1,4130,5900
6610161,100,390,10,3900,2340,6,21060,23400
1.00E+12,200,2503,7,35760,5006,2,66514,71520
1.00E+12,501,218,10.9,2000,436,2,3564,4000
8333610,501,457,10.9,4200,457,1,3743,4200
1.00E+12,310,298,10,2980,596,2,5364,5960
9661140,310,274,7.9,3480,274,1,3206,3480
2.10E+12,310,770,10,7700,770,1,6930,7700
2.10E+12,310,3484,35.2,9900,17420,5,32080,49500
1.00E+12,310,348,10,3480,1740,5,15660,17400
1.00E+12,310,72,5,1450,720,10,13780,14500
7058786,310,398,10,3980,398,1,3582,3980
6609543,310,159,7,2280,1272,8,16968,18240
1.00E+12,310,787,7.9,9900,1574,2,18226,19800
6609434,310,269,5,5380,269,1,5111,5380
1.00E+12,310,495,5,9900,495,1,9405,9900
1.00E+12,310,329,4.3,7580,329,1,7251,7580
1.00E+12,310,125,4.3,2880,125,1,2755,2880
1.00E+12,200,1225,7,17500,1225,1,16275,17500
7858987,310,558,7,7980,1116,2,14844,15960
6612293,310,179,5,3580,358,2,6802,7160
1.00E+12,310,214,5,4280,214,1,4066,4280
2.10E+12,310,598,10,5980,2392,4,21528,23920
2.10E+12,310,198,10,1980,1188,6,10692,11880
2.10E+12,310,308,10,3080,308,1,2772,3080
8074909,310,548,10,5480,1096,2,9864,10960
2.10E+12,200,3514,10,35140,3514,1,31626,35140
1.00E+12,310,1995,5,39900,1995,1,37905,39900
1.00E+12,200,16530,14.5,114000,16530,1,97470,114000
1.00E+12,240,960,20,4800,960,1,3840,4800
1.00E+12,310,290,10,2900,290,1,2610,2900
1.00E+12,310,390,10,3900,390,1,3510,3900
8930181,310,299,5,5980,299,1,5681,5980
1.00E+12,310,176,8.9,1980,176,1,1804,1980
1.00E+12,310,623,7,8900,1869,3,24831,26700
1.00E+12,310,558,7,7980,558,1,7422,7980
1.00E+12,200,6075,15,40500,6075,1,34425,40500
2.10E+12,310,445,5,8900,890,2,16910,17800
1.00E+12,310,449,5,8980,898,2,17062,17960
1.00E+12,310,49,5,980,588,12,11172,11760
1.00E+12,310,1898,19,9980,13286,7,56574,69860
1.00E+12,310,298,10,2980,298,1,2682,2980
1.00E+12,310,198,10,1980,396,2,3564,3960
1.00E+12,100,1244,14.5,8580,2488,2,14672,17160
1.00E+12,100,566,19,2980,1698,3,7242,8940
1.00E+12,310,764,9.8,7780,764,1,7016,7780
1.00E+12,310,1320,7.6,17400,2640,2,32160,34800
1.00E+12,300,8350,20.9,39900,8350,1,31550,39900
1.00E+12,310,166,9.3,1780,166,1,1614,1780
7922852,310,392,9.4,4180,392,1,3788,4180
2.10E+12,310,1094,27.5,3980,1094,1,2886,3980
1.00E+12,310,467,9.4,4980,467,1,4513,4980
2.10E+12,200,2866,23.9,11980,14330,5,45570,59900
6615155,601,99,5,1980,297,3,5643,5940
6823729,310,167,6,2800,167,1,2633,2800
1.00E+12,310,412,6,6900,412,1,6488,6900
1.00E+12,310,275,6,4600,275,1,4325,4600
1.00E+12,310,94,6,1580,472,5,7428,7900
1.00E+12,310,1553,6,25800,1553,1,24247,25800
1.00E+12,205,4436,24.8,17900,4436,1,13464,17900
1.00E+12,200,8390,10,83900,25170,3,226530,251700
1.00E+12,310,15358,17.1,90000,15358,1,74642,90000
1.00E+12,100,15358,17.1,90000,15358,1,74642,90000
1.00E+12,200,5871,19,30900,64581,11,275319,339900
6621587,310,68,6.9,980,476,7,6384,6860
1.00E+12,310,89,7,1280,89,1,1191,1280
8734935,310,488,7,6980,976,2,12984,13960
8116665,310,75,6.9,1080,150,2,2010,2160
1.00E+12,310,243,7,3480,1458,6,19422,20880
1.00E+12,300,255575,18.8,1358000,255575,1,1102425,1358000
2.10E+12,200,1379,18.4,7480,1379,1,6101,7480
6618348,310,294,5.9,4950,294,1,4656,4950
1.00E+12,310,672,5.9,11300,672,1,10628,11300
1.00E+12,310,287,8.6,3340,287,1,3053,3340
7922852,310,292,7,4180,584,2,7776,8360
1.00E+12,310,488,7,6980,488,1,6492,6980
2.10E+12,200,7603,19.2,39500,53221,7,223279,276500
1.00E+12,310,233,10.8,2150,233,1,1917,2150
1.00E+12,310,596,10.9,5480,596,1,4884,5480
7709932,501,247,10.8,2280,247,1,2033,2280
1.00E+12,501,596,10.9,5480,596,1,4884,5480
2.10E+12,340,138,7,1980,276,2,3684,3960
1.00E+12,100,249,5,4980,249,1,4731,4980
2.10E+12,310,11397,28.9,39500,22794,2,56206,79000
1.00E+12,100,2086,16.3,12800,2086,1,10714,12800
8333643,100,733,16.3,4500,733,1,3767,4500
2.10E+12,310,129,5,2580,258,2,4902,5160
1.00E+12,310,249,5,4980,249,1,4731,4980
1.00E+12,310,99,5,1980,99,1,1881,1980
1.00E+12,310,79,5,1580,79,1,1501,1580
1.00E+12,310,249,5,4980,498,2,9462,9960
8068378,310,129,5,2580,129,1,2451,2580
2.10E+12,310,289,5,5780,1156,4,21964,23120
1.00E+12,310,280,10,2800,280,1,2520,2800
1.00E+12,310,748,10,7480,748,1,6732,7480
6801265,100,79,2,3980,79,1,3901,3980
2.10E+12,310,798,10,7980,3192,4,28728,31920
2.10E+12,310,598,10,5980,4784,8,43056,47840
7518252,310,220,10,2200,1100,5,9900,11000
2.10E+12,310,300,10,3000,2400,8,21600,24000
1.00E+12,240,3330,16.8,19800,3330,1,16470,19800
2.10E+12,310,798,10,7980,798,1,7182,7980
6609591,310,458,10,4580,458,1,4122,4580
1.00E+12,310,598,10,5980,598,1,5382,5980
6957391,310,458,10,4580,1832,4,16488,18320
6613803,310,250,10,2500,500,2,4500,5000
7532989,310,250,8.9,2800,250,1,2550,2800
1.00E+12,310,355,8.9,3980,355,1,3625,3980
1.00E+12,310,531,8.9,5950,531,1,5419,5950
1.00E+12,310,1255,9,13900,1255,1,12645,13900
1.00E+12,310,603,9.2,6580,603,1,5977,6580
6613112,310,243,7,3480,729,3,9711,10440
1.00E+12,310,756,7,10800,2268,3,30132,32400
1.00E+12,310,4480,14.5,30900,4480,1,26420,30900
1.00E+12,200,1100,5,22120,1100,1,21020,22120
1.00E+12,310,4902,19,25800,4902,1,20898,25800
2.10E+12,205,1597,40.1,3980,3194,2,4766,7960
8075882,601,517,11.5,4500,517,1,3983,4500
1.00E+12,310,609,6.8,8900,609,1,8291,8900
10467212,310,599,6.8,8750,599,1,8151,8750
1.00E+12,310,238,6.8,3480,238,1,3242,3480
1.00E+12,310,404,6.8,5900,404,1,5496,5900
1.00E+12,310,341,6.8,4980,341,1,4639,4980
8055821,601,1093,11.5,9500,1093,1,8407,9500
8075835,601,1331,11.6,11500,1331,1,10169,11500
1.00E+12,240,1156,20,5780,2312,2,9248,11560
1.00E+12,500,7179,20.5,35000,7179,1,27821,35000
1.00E+12,500,6020,17.2,35000,12040,2,57960,70000
1.00E+12,340,499,5.6,8900,499,1,8401,8900
1.00E+12,310,249,5,4980,249,1,4731,4980
1.00E+12,310,395,5,7900,395,1,7505,7900
1.00E+12,340,252,6.8,3680,252,1,3428,3680
1.00E+12,340,685,6.9,9980,685,1,9295,9980
8634542,340,376,6.9,5480,376,1,5104,5480
1.00E+12,100,281,19,1480,281,1,1199,1480
1.00E+12,100,1516,19,7980,1516,1,6464,7980
1.00E+12,100,376,19,1980,376,1,1604,1980
1.00E+12,500,6296,23.3,27000,6296,1,20704,27000
1.00E+12,310,68,7,980,410,6,5470,5880
10458872,310,314,7,4500,314,1,4186,4500
1.00E+12,310,1298,10,12980,2596,2,23364,25960
1.00E+12,310,229,7,3280,916,4,12204,13120
1.00E+12,310,648,16.3,3980,2592,4,13328,15920
1.00E+12,310,340,10,3400,340,1,3060,3400
1.00E+12,310,1148,10,11480,4592,4,41328,45920
8302192,310,348,7,4980,2088,6,27792,29880
2.10E+12,310,1313,24,5480,1313,1,4167,5480
2.10E+12,310,896,7,12800,1792,2,23808,25600
8483213,310,758,10,7580,1516,2,13644,15160
2.10E+12,601,183,9.7,1880,366,2,3394,3760
1.00E+12,310,133,7,1900,133,1,1767,1900
7516320,310,483,7,6900,483,1,6417,6900
1.00E+12,310,805,9,8980,805,1,8175,8980
2.10E+12,310,82,5.2,1580,82,1,1498,1580
2.10E+12,310,124,5.2,2380,124,1,2256,2380
1.00E+12,310,119,5.2,2280,119,1,2161,2280
1.00E+12,310,118,10,1180,235,2,2125,2360
2.10E+12,310,137,9.9,1380,137,1,1243,1380
1.00E+12,310,208,7,2980,208,1,2772,2980
2.10E+12,310,390,7,5580,2730,7,36330,39060
1.00E+12,601,167,13,1280,167,1,1113,1280
1.00E+12,601,259,13.1,1980,259,1,1721,1980
7628565,601,507,13.1,3880,507,1,3373,3880
1.00E+12,310,259,13.1,1980,518,2,3442,3960
1.00E+12,310,259,13.1,1980,259,1,1721,1980
7263444,310,363,13.1,2780,726,2,4834,5560
1.00E+12,310,167,13,1280,167,1,1113,1280
1.00E+12,310,83,8.5,980,166,2,1794,1960
1.00E+12,200,5430,18.1,30000,5430,1,24570,30000
1.00E+12,310,3843,7,54900,3843,1,51057,54900
1.00E+12,310,1290,10,12900,3870,3,34830,38700
1.00E+12,200,2635,10,26350,5270,2,47430,52700
1.00E+12,200,24560,22.1,111200,98240,4,346560,444800
1.00E+12,310,89,7.4,1200,89,1,1111,1200
2.10E+12,310,857,7.5,11500,857,1,10643,11500
1.00E+12,310,214,7.4,2880,214,1,2666,2880
1.00E+12,310,446,7.5,5980,446,1,5534,5980
1.00E+12,310,7221,18.1,39900,7221,1,32679,39900
1.00E+12,200,3963,18.1,21900,3963,1,17937,21900
1.00E+12,200,7221,18.1,39900,7221,1,32679,39900
1.00E+12,100,2993,15.3,19500,5986,2,33014,39000
1.00E+12,200,3690,10,36900,3690,1,33210,36900
7516325,310,61,1,5900,61,1,5839,5900
8531580,310,82,1,7980,82,1,7898,7980
1.00E+12,200,16200,20,81000,16200,1,64800,81000
1.00E+12,310,418,7,5980,418,1,5562,5980
1.00E+12,205,447,15,2980,894,2,5066,5960
1.00E+12,310,898,10,8980,1796,2,16164,17960
9699056,310,873,7,12480,2619,3,34821,37440
9699059,310,978,7,13980,1956,2,26004,27960
1.00E+12,100,350,10,3500,350,1,3150,3500
1.00E+12,340,19745,55,35900,19745,1,16155,35900
8094408,601,157,5,3150,157,1,2993,3150
1.00E+12,310,34551,34.9,99000,34551,1,64449,99000
1.00E+12,200,34551,34.9,99000,34551,1,64449,99000
1.00E+12,310,6102,9,67900,6102,1,61798,67900
1.00E+12,310,411,7,5880,1233,3,16407,17640
1.00E+12,200,500,4,12500,500,1,12000,12500
2.10E+12,200,1000,16.7,5980,5000,5,24900,29900
1.00E+12,200,17820,18,99000,17820,1,81180,99000
1.00E+12,240,1350,30,4500,6750,5,15750,22500
8098380,310,138,7,1980,138,1,1842,1980
1.00E+12,200,4200,10,42000,4200,1,37800,42000
2.10E+12,200,3081,34.3,8980,3081,1,5899,8980
2.10E+12,340,3081,34.3,8980,3081,1,5899,8980
2.10E+12,310,199,5,3980,597,3,11343,11940
1.00E+12,310,192,5,3840,768,4,14592,15360
1.00E+12,300,39595,20.9,189000,79190,2,298810,378000
1.00E+12,310,417,10,4180,417,1,3763,4180
7938700,310,7964,55,14480,47784,6,39096,86880
1.00E+12,310,980,10,9800,1960,2,17640,19600
1.00E+12,205,5000,25.1,19940,5000,1,14940,19940
1.00E+12,310,99,5,1980,198,2,3762,3960
1.00E+12,310,548,10,5480,1644,3,14796,16440
1.00E+12,310,15360,25.6,60000,15360,1,44640,60000
1.00E+12,310,578,8.9,6480,578,1,5902,6480
2.10E+12,340,124,7,1780,124,1,1656,1780
1.00E+12,310,9466,12.4,76500,9466,1,67034,76500
1.00E+12,205,855,19,4500,855,1,3645,4500
1.00E+12,310,239,5,4780,239,1,4541,4780
1.00E+12,500,9060,16.5,55000,9060,1,45940,55000
1.00E+12,310,68,6.8,990,203,3,2767,2970
1.00E+12,310,121,6.8,1780,121,1,1659,1780
1.00E+12,310,608,6.8,8880,608,1,8272,8880
1.00E+12,205,7163,20,35900,7163,1,28737,35900
1.00E+12,310,1090,10,10900,1090,1,9810,10900
1.00E+12,310,124,5,2480,620,5,11780,12400
1.00E+12,310,214,9,2380,214,1,2166,2380
1.00E+12,310,178,9,1980,178,1,1802,1980
1.00E+12,500,15756,20.2,78000,15756,1,62244,78000
1.00E+12,310,158,10,1580,316,2,2844,3160
2.10E+12,310,1133,25.9,4380,1133,1,3247,4380
1.00E+12,310,145,7.3,1980,145,1,1835,1980
2.10E+12,100,696,11.6,5980,696,1,5284,5980
1.00E+12,310,96,7,1380,768,8,10272,11040
7038566,310,306,7,4380,918,3,12222,13140
1.00E+12,310,700,7,9980,1400,2,18560,19960
1.00E+12,310,2130,7,30300,2130,1,28170,30300
1.00E+12,310,274,5,5490,274,1,5216,5490
1.00E+12,310,192,19.2,1000,192,1,808,1000
1.00E+12,200,192,19.2,1000,192,1,808,1000
1.00E+12,310,1998,10,19980,3996,2,35964,39960
1.00E+12,200,1620,18,9000,3240,2,14760,18000
1.00E+12,240,238,10,2380,476,2,4284,4760
1.00E+12,310,334,10,3340,668,2,6012,6680
2.10E+12,310,410,31.5,1300,410,1,890,1300
1.00E+12,310,334,10,3340,334,1,3006,3340
1.00E+12,310,110,7,1580,220,2,2940,3160
1.00E+12,310,24675,23.5,105000,24675,1,80325,105000
1.00E+12,300,12880,28,46000,25760,2,66240,92000
1.00E+12,310,757,16.3,4650,1514,2,7786,9300
1.00E+12,310,1626,16.3,9980,1626,1,8354,9980
2.10E+12,200,1766,25.6,6900,1766,1,5134,6900
1.00E+12,310,124,5,2480,124,1,2356,2480
2.10E+12,310,149,5,2980,298,2,5662,5960
8550405,100,1120,10,11200,1120,1,10080,11200
6609536,100,210,10,2100,420,2,3780,4200
1.00E+12,310,129,5,2580,129,1,2451,2580
1.00E+12,310,12180,14.5,84000,12180,1,71820,84000
6609427,310,122,5,2450,610,5,11640,12250
1.00E+12,310,98,10,980,1960,20,17640,19600
1.00E+12,310,952,7.9,11980,952,1,11028,11980
1.00E+12,310,138,7,1980,138,1,1842,1980
1.00E+12,310,208,7,2980,832,4,11088,11920
1.00E+12,310,236,7,3380,708,3,9432,10140
1.00E+12,100,160,2,8000,320,2,15680,16000
6612114,310,1460,9.7,14980,1460,1,13520,14980
1.00E+12,310,959,9.7,9900,959,1,8941,9900
1.00E+12,310,95,9.7,980,379,4,3541,3920
1.00E+12,310,499,5,9980,998,2,18962,19960
1.00E+12,310,299,5,5980,299,1,5681,5980
2.10E+12,310,160,5,3200,160,1,3040,3200
2.10E+12,310,402,33.5,1200,2010,5,3990,6000
1.00E+12,511,213,20.8,1020,2550,12,9690,12240
1.00E+12,310,213,20.8,1020,2550,12,9690,12240
1.00E+12,310,795,5,15900,795,1,15105,15900
1.00E+12,310,1673,7,23900,1673,1,22227,23900
1.00E+12,310,18899,26.5,71400,18899,1,52501,71400
1.00E+12,200,6222,18.3,34000,6222,1,27778,34000
2.10E+12,200,1370,20,6850,9590,7,38360,47950
1.00E+12,310,138,7,1980,276,2,3684,3960
1.00E+12,310,129,5,2580,129,1,2451,2580
7710017,310,698,7,9980,698,1,9282,9980
1.00E+12,200,16038,18,89100,16038,1,73062,89100
8356931,310,399,5,7980,798,2,15162,15960
2.10E+12,310,1932,35.3,5480,3864,2,7096,10960
1.00E+12,310,487,7.5,6480,487,1,5993,6480
1.00E+12,200,520,4,13000,520,1,12480,13000
1.00E+12,310,10000,4.1,245000,10000,1,235000,245000
1.00E+12,200,4123,7,58900,4123,1,54777,58900
1.00E+12,310,35,7,500,70,2,930,1000
8211145,310,427,7,6100,427,1,5673,6100
1.00E+12,310,1045,8.7,11980,1045,1,10935,11980
1.00E+12,310,1307,8.7,14980,1307,1,13673,14980
4867801,200,2350,5,47000,2350,1,44650,47000
1.00E+12,300,2500,20,12500,2500,1,10000,12500
1.00E+12,300,1000,16.7,5980,3000,3,14940,17940
7095621,310,288,10,2880,576,2,5184,5760
8104635,310,224,19,1180,448,2,1912,2360
2.10E+12,310,417,14.5,2880,834,2,4926,5760
2.10E+12,310,453,7,6480,1359,3,18081,19440
1.00E+12,310,590,10,5900,1180,2,10620,11800
1.00E+12,310,390,10,3900,390,1,3510,3900
2.10E+12,310,870,14.5,6000,870,1,5130,6000
7580677,310,280,9.4,2980,280,1,2700,2980
7674007,601,249,5,4980,249,1,4731,4980
1.00E+12,501,4251,10.9,39000,4251,1,34749,39000
1.00E+12,310,2147,22.6,9500,2147,1,7353,9500
1.00E+12,310,228,10,2280,684,3,6156,6840
2.10E+12,310,49,4.9,990,98,2,1882,1980
2.10E+12,310,215,5,4300,645,3,12255,12900
1.00E+12,310,266,7,3800,266,1,3534,3800
1.00E+12,310,3980,20,19900,3980,1,15920,19900
1.00E+12,310,1227,9.5,12980,2454,2,23506,25960
7022400,240,2844,30,9480,5688,2,13272,18960
1.00E+12,200,2990,5,59800,2990,1,56810,59800
1.00E+12,601,545,5,10900,545,1,10355,10900
1.00E+12,310,399,5,7980,798,2,15162,15960
1.00E+12,310,398,10,3980,1194,3,10746,11940
10015897,310,49,9.8,498,196,4,1796,1992
1.00E+12,511,3490,50,6980,41880,12,41880,83760
9077389,310,845,8.5,9900,845,1,9055,9900
1.00E+12,340,243,7,3480,243,1,3237,3480
1.00E+12,340,439,7,6280,439,1,5841,6280
8953588,310,474,7,6780,1422,3,18918,20340
1.00E+12,310,593,7,8480,593,1,7887,8480
1.00E+12,200,3150,15,21000,3150,1,17850,21000
1.00E+12,310,270,5,5400,540,2,10260,10800
1.00E+12,310,764,8.5,8980,764,1,8216,8980
1.00E+12,310,399,5,7980,399,1,7581,7980
1.00E+12,340,3095,52.5,5900,6190,2,5610,11800
8396098,340,194,7,2780,194,1,2586,2780
1.00E+12,310,348,10,3480,348,1,3132,3480
6593386,310,12969,13.5,96000,12969,1,83031,96000
2.10E+12,310,84,5,1680,84,1,1596,1680
8265786,310,89,5,1780,267,3,5073,5340
2.10E+12,310,294,5,5880,1176,4,22344,23520
1.00E+12,200,3533,13.6,25900,3533,1,22367,25900
7889763,310,180,7,2580,900,5,12000,12900
1.00E+12,310,222,7,3180,222,1,2958,3180
1.00E+12,300,4298,21.6,19900,8596,2,31204,39800
1.00E+12,310,125,5,2500,250,2,4750,5000
1.00E+12,310,1045,55,1900,6270,6,5130,11400
1.00E+12,511,1045,55,1900,6270,6,5130,11400
8315733,310,124,5,2480,248,2,4712,4960
1.00E+12,200,7080,20,35400,14160,2,56640,70800
8677,310,10122,16.3,62000,10122,1,51878,62000
8040272,310,214,7,3050,214,1,2836,3050
1.00E+12,310,490,7,6980,490,1,6490,6980
8844794,310,175,8.8,1980,175,1,1805,1980
6822794,310,433,8.9,4850,1733,4,17667,19400
6609443,310,370,8.9,4180,370,1,3810,4180
1.00E+12,310,376,9.9,3780,376,1,3404,3780
8288041,310,184,5,3680,184,1,3496,3680
1.00E+12,200,27272,20.4,134000,27272,1,106728,134000
1.00E+12,200,7935,15,52900,7935,1,44965,52900
1.00E+12,310,343,8.6,3980,343,1,3637,3980
1.00E+12,310,601,8.6,6980,601,1,6379,6980
1.00E+12,310,860,8.6,9980,860,1,9120,9980
2.10E+12,310,1880,19.2,9800,1880,1,7920,9800
1.00E+12,200,880,5,17600,880,1,16720,17600
1.00E+12,240,3692,37,9980,3692,1,6288,9980
1.00E+12,240,3692,37,9980,7384,2,12576,19960
1.00E+12,310,648,16.3,3980,648,1,3332,3980
8562095,310,440,11.6,3780,440,1,3340,3780
8562095,100,440,11.6,3780,440,1,3340,3780
1.00E+12,200,22574,27.1,83300,22574,1,60726,83300
1.00E+12,340,1048,7,14980,2096,2,27864,29960
8532509,310,324,5,6480,324,1,6156,6480
1.00E+12,310,1296,9.1,14280,1296,1,12984,14280
1.00E+12,310,2192,13.7,16000,6575,3,41425,48000
1.00E+12,310,988,10,9880,988,1,8892,9880
1.00E+12,300,2648,7.9,33400,2648,1,30752,33400
10008970,310,257,7.8,3280,257,1,3023,3280
1.00E+12,310,124,7.8,1580,124,1,1456,1580
1.00E+12,310,422,7.8,5380,422,1,4958,5380
1.00E+12,200,5791,17.5,33000,5791,1,27209,33000
1.00E+12,310,199,5,3980,398,2,7562,7960
8367117,310,166,7,2380,332,2,4428,4760
2.10E+12,310,595,30.1,1980,595,1,1385,1980
2.10E+12,200,1343,25.4,5280,1343,1,3937,5280
6866572,205,2050,34.7,5900,2050,1,3850,5900
6618411,310,2500,10,25000,2500,1,22500,25000
6867881,310,828,10,8280,828,1,7452,8280
1.00E+12,310,228,10,2280,228,1,2052,2280
1.00E+12,310,120,10,1200,1800,15,16200,18000
8642235,100,939,14.5,6480,1878,2,11082,12960
6615122,100,1212,19,6380,1212,1,5168,6380
1.00E+12,100,577,14.5,3980,577,1,3403,3980
1.00E+12,100,1520,17.1,8900,1520,1,7380,8900
1.00E+12,310,138,7,1980,276,2,3684,3960
1.00E+12,200,3560,23.7,15000,3560,1,11440,15000
1.00E+12,300,3560,23.7,15000,3560,1,11440,15000
1.00E+12,300,42960,24,179000,42960,1,136040,179000
1.00E+12,100,1121,11.8,9500,1121,1,8379,9500
1.00E+12,500,7210,24.9,29000,7210,1,21790,29000
1.00E+12,200,22752,16,142200,22752,1,119448,142200
1.00E+12,100,468,10,4680,936,2,8424,9360
1.00E+12,310,299,5,5980,299,1,5681,5980
1.00E+12,310,219,5,4380,2409,11,45771,48180
2.10E+12,310,249,5,4980,996,4,18924,19920
1.00E+12,200,2746,10.9,25200,2746,1,22454,25200
1.00E+12,310,539,9,5980,539,1,5441,5980
1.00E+12,240,1183,35,3380,7098,6,13182,20280
1.00E+12,200,1130,10,11300,1130,1,10170,11300
1.00E+12,310,1490,10,14900,1490,1,13410,14900
2.10E+12,310,148,10,1480,592,4,5328,5920
1.00E+12,310,309,5,6180,309,1,5871,6180
1.00E+12,310,299,5,5980,299,1,5681,5980
1.00E+12,240,6050,42.6,14200,42350,7,57050,99400
1.00E+12,240,6050,42.6,14200,6050,1,8150,14200
10046344,310,909,16.3,5580,1818,2,9342,11160
1.00E+12,310,5187,19,27300,31122,6,132678,163800
1.00E+12,310,1032,8.6,11980,1032,1,10948,11980
8634488,310,515,8.6,5980,515,1,5465,5980
1.00E+12,310,998,8.6,11580,998,1,10582,11580
1.00E+12,310,860,8.6,9980,860,1,9120,9980
1.00E+12,310,1727,8.6,19980,1727,1,18253,19980
2.10E+12,310,1776,20.9,8480,5328,3,20112,25440
1.00E+12,310,418,7,5980,1254,3,16686,17940
1.00E+12,310,10575,23.5,45000,10575,1,34425,45000
1.00E+12,310,49,4.9,990,147,3,2823,2970
2.10E+12,200,2000,9.6,20800,2000,1,18800,20800
1.00E+12,300,469,7,6700,1407,3,18693,20100
1.00E+12,310,840,7,12000,840,1,11160,12000
1.00E+12,100,198,10,1980,198,1,1782,1980
1.00E+12,310,108,10,1080,864,8,7776,8640
2.10E+12,310,1516,19,7980,1516,1,6464,7980
1.00E+12,310,248,10,2480,496,2,4464,4960
6609249,310,450,10,4500,450,1,4050,4500
2.10E+12,310,643,10,6430,643,1,5787,6430
1.00E+12,310,693,7,9900,693,1,9207,9900
1.00E+12,310,5700,19,30000,5700,1,24300,30000
10355529,310,704,16.3,4320,704,1,3616,4320
2.10E+12,310,485,16.3,2980,485,1,2495,2980
1.00E+12,310,576,11.6,4950,1152,2,8748,9900
1.00E+12,310,583,9.7,5980,583,1,5397,5980
2.10E+12,310,858,9.8,8800,858,1,7942,8800
8351806,310,558,7,7980,558,1,7422,7980
1.00E+12,310,84,5,1680,168,2,3192,3360
7280815,340,6662,37.2,17900,6662,1,11238,17900
6951675,310,505,9.6,5280,505,1,4775,5280
8491731,310,344,9.6,3600,344,1,3256,3600
8333668,310,59,7.9,750,59,1,691,750
1.00E+12,310,286,7.9,3600,1428,5,16572,18000
9749223,310,445,5,8900,445,1,8455,8900
1.00E+12,310,68,6.9,980,1564,23,20976,22540
1.00E+12,310,320,7,4580,320,1,4260,4580
1.00E+12,200,3000,10,30000,3000,1,27000,30000
1.00E+12,240,2500,19.4,12900,5000,2,20800,25800
7186745,310,1198,10,11980,5990,5,53910,59900
8300137,310,445,10,4450,445,1,4005,4450
10529379,310,296,5.9,4980,296,1,4684,4980
1.00E+12,310,177,5.9,2980,177,1,2803,2980
1.00E+12,310,296,5.9,4980,592,2,9368,9960
6610147,310,519,17.4,2980,519,1,2461,2980
2.10E+12,310,170,8.2,2080,170,1,1910,2080
1.00E+12,310,293,8.2,3580,293,1,3287,3580
6615245,310,139,8.2,1700,278,2,3122,3400
1.00E+12,310,211,10.7,1980,634,3,5306,5940
1.00E+12,240,363,13.1,2780,363,1,2417,2780
1.00E+12,310,57,3.4,1680,57,1,1623,1680
1.00E+12,310,335,3.4,9800,335,1,9465,9800
1.00E+12,310,236,3.4,6900,236,1,6664,6900
1.00E+12,310,579,3.4,16900,579,1,16321,16900
1.00E+12,310,67,3.4,1980,67,1,1913,1980
1.00E+12,310,438,3.4,12800,438,1,12362,12800
1.00E+12,310,136,3.4,3980,136,1,3844,3980
6609873,310,84,3.4,2480,84,1,2396,2480
1.00E+12,500,34330,22.4,153300,34330,1,118970,153300
1.00E+12,200,65000,10,650000,65000,1,585000,650000
8121013,501,630,10.5,5980,630,1,5350,5980
10698740,310,894,10.5,8480,894,1,7586,8480
9014178,310,443,10.5,4200,443,1,3757,4200
1.00E+12,100,736,10.5,6980,736,1,6244,6980
2.10E+12,205,2048,37.4,5480,2048,1,3432,5480
7452331,100,137,10.5,1300,274,2,2326,2600
8333643,601,652,14.5,4500,652,1,3848,4500
1.00E+12,240,1610,16.1,10000,1610,1,8390,10000
1.00E+12,240,1046,16.1,6500,1046,1,5454,6500
2.10E+12,310,550,10,5500,1100,2,9900,11000
2.10E+12,310,1646,28,5880,3292,2,8468,11760
2.10E+12,310,720,10,7200,2160,3,19440,21600
1.00E+12,200,8050,15,53700,8050,1,45650,53700
1.00E+12,200,490,2,24900,490,1,24410,24900
1.00E+12,300,2000,28.7,6980,8000,4,19920,27920
7308013,310,249,5,4980,249,1,4731,4980
1.00E+12,340,570,16.3,3500,570,1,2930,3500
1.00E+12,100,418,10,4180,836,2,7524,8360
1.00E+12,200,57880,15.5,373000,57880,1,315120,373000
1.00E+12,310,788,10,7880,788,1,7092,7880
1.00E+12,200,5550,11.1,50000,11100,2,88900,100000
1.00E+12,200,9440,20,47200,9440,1,37760,47200
1.00E+12,200,1690,10,16900,1690,1,15210,16900
1.00E+12,310,6791,10.4,65500,6791,1,58709,65500
1.00E+12,500,170,0.9,19900,170,1,19730,19900
1.00E+12,200,1844,23.1,8000,1844,1,6156,8000
1.00E+12,100,3872,23,16800,7744,2,25856,33600
1.00E+12,310,258,4.7,5450,258,1,5192,5450
1.00E+12,310,330,4.7,6980,330,1,6650,6980
1.00E+12,310,516,4.7,10900,516,1,10384,10900
8886655,310,202,4.7,4280,202,1,4078,4280
1.00E+12,310,8195,55,14900,32780,4,26820,59600
1.00E+12,200,919,8.4,10900,919,1,9981,10900
6916804,310,349,5,6980,1047,3,19893,20940
1.00E+12,240,1666,8.8,19000,1666,1,17334,19000
10717442,310,388,10,3880,1552,4,13968,15520
2.10E+12,310,121,4.2,2900,242,2,5558,5800
2.10E+12,310,83,4.2,1980,330,4,7590,7920
1.00E+12,310,103,4.2,2480,206,2,4754,4960
6609752,310,312,4.2,7480,624,2,14336,14960
8225929,310,291,4.2,6980,582,2,13378,13960
1.00E+12,310,5170,23.5,22000,5170,1,16830,22000
1.00E+12,200,10120,44,23000,10120,1,12880,23000
1.00E+12,310,2000,10,20000,2000,1,18000,20000
1.00E+12,310,4565,16.2,28100,4565,1,23535,28100
1.00E+12,310,519,5,10380,519,1,9861,10380
1.00E+12,501,21,1,2150,21,1,2129,2150
1.00E+12,310,495,5,9900,495,1,9405,9900
1.00E+12,511,3623,52.5,6900,21735,6,19665,41400
1.00E+12,340,82,6.9,1180,164,2,2196,2360
9751028,310,1078,10,10780,1078,1,9702,10780
1.00E+12,310,177,5,3550,885,5,16865,17750
1.00E+12,310,223,9,2480,223,1,2257,2480
1.00E+12,200,11800,20,59000,11800,1,47200,59000
1.00E+12,310,147,14.4,1020,147,1,873,1020
1.00E+12,310,298,10,2980,894,3,8046,8940
1.00E+12,310,598,10,5980,598,1,5382,5980
1.00E+12,310,590,10,5900,590,1,5310,5900
1.00E+12,310,97,12.4,780,193,2,1367,1560
1.00E+12,200,3420,18,19000,3420,1,15580,19000
7335759,310,378,10,3780,378,1,3402,3780
1.00E+12,310,398,10,3980,796,2,7164,7960
1.00E+12,310,299,5,5980,299,1,5681,5980
8083293,310,495,10,4950,990,2,8910,9900
6835815,100,287,14.5,1980,861,3,5079,5940
1.00E+12,200,4075,14.1,29000,4075,1,24925,29000
1.00E+12,310,194,5,3880,194,1,3686,3880
1.00E+12,310,416,7,5950,416,1,5534,5950
1.00E+12,310,99,5,1980,693,7,13167,13860
1.00E+12,100,1920,23.1,8300,3840,2,12760,16600
1.00E+12,200,5330,16.3,32700,5330,1,27370,32700
1.00E+12,310,309,7.8,3980,309,1,3671,3980
1.00E+12,100,6422,18.4,34900,12843,2,56957,69800
1.00E+12,200,4213,18.4,22900,8425,2,37375,45800
1.00E+12,200,856,5.9,14500,2568,3,40932,43500
1.00E+12,500,856,5.9,14500,2568,3,40932,43500
1.00E+12,310,3721,57.2,6500,7442,2,5558,13000
1.00E+12,200,2050,7,29400,6150,3,82050,88200
1.00E+12,200,270,5.5,4900,540,2,9260,9800
1.00E+12,200,3840,5,76800,3840,1,72960,76800
1.00E+12,310,981,9.8,9980,981,1,8999,9980
1.00E+12,310,686,9.8,6980,686,1,6294,6980
1.00E+12,310,989,9.9,9980,989,1,8991,9980
9527127,310,784,9.8,7980,784,1,7196,7980
1.00E+12,310,578,9.8,5880,578,1,5302,5880
1.00E+12,240,946,28,3380,3784,4,9736,13520
8114120,310,1932,46,4200,9660,5,11340,21000
8882973,310,838,8.8,9480,838,1,8642,9480
1.00E+12,310,1140,8.8,12900,1140,1,11760,12900
1.00E+12,310,1380,8.9,15500,1380,1,14120,15500
2.10E+12,310,245,8.8,2780,245,1,2535,2780
2.10E+12,200,1866,17.3,10800,1866,1,8934,10800
1.00E+12,310,440,5,8800,880,2,16720,17600
1.00E+12,310,908,7,12980,908,1,12072,12980
1.00E+12,310,1048,7,14980,1048,1,13932,14980
1.00E+12,310,628,7,8980,1256,2,16704,17960
9005828,310,848,10,8480,1696,2,15264,16960
8632626,310,781,8.7,8980,781,1,8199,8980
7109715,310,84,5,1680,672,8,12768,13440
2.10E+12,310,399,5,7980,798,2,15162,15960
1.00E+12,310,693,17.8,3900,693,1,3207,3900
1.00E+12,100,4980,17.8,28000,9960,2,46040,56000
1.00E+12,200,871,17.8,4900,1742,2,8058,9800
1.00E+12,500,3540,15,23600,7080,2,40120,47200
1.00E+12,200,3560,7.8,45900,3560,1,42340,45900
1.00E+12,310,9358,24.6,38000,9358,1,28642,38000
1.00E+12,310,390,10,3900,390,1,3510,3900
1.00E+12,310,3778,23.8,15900,3778,1,12122,15900
2.10E+12,310,532,9.5,5580,532,1,5048,5580
1.00E+12,240,3778,23.8,15900,3778,1,12122,15900
1.00E+12,200,6360,24,26500,57240,9,181260,238500
1.00E+12,310,2958,29.9,9900,2958,1,6942,9900
8333411,601,218,22.9,950,218,1,732,950
7445176,100,143,14.4,990,143,1,847,990
1.00E+12,200,2989,29.9,10000,2989,1,7011,10000
1.00E+12,500,3903,12.3,31800,3903,1,27897,31800
1.00E+12,310,695,5,13900,695,1,13205,13900
2.10E+12,310,367,20.4,1800,734,2,2866,3600
9014178,310,415,9.9,4200,415,1,3785,4200
1.00E+12,310,5815,58.7,9900,69779,12,49021,118800
7022265,310,166,7,2380,664,4,8856,9520
1.00E+12,310,344,5,6880,2408,7,45752,48160
1.00E+12,310,1365,5,27300,1365,1,25935,27300
1.00E+12,310,1725,14.5,11900,1725,1,10175,11900
1.00E+12,601,1725,14.5,11900,1725,1,10175,11900
1.00E+12,310,348,7,4980,1740,5,23160,24900
1.00E+12,310,896,7,12800,896,1,11904,12800
4894175,501,23860,12.1,198000,23860,1,174140,198000
7903665,100,133,10,1330,266,2,2394,2660
1.00E+12,310,718,10,7180,1436,2,12924,14360
1.00E+12,310,852,5.8,14800,852,1,13948,14800
1.00E+12,200,4093,15.2,26900,4093,1,22807,26900
1.00E+12,310,683,7.6,8980,683,1,8297,8980
1.00E+12,200,6605,12.2,54000,6605,1,47395,54000
1.00E+12,310,278,7,3980,278,1,3702,3980
1.00E+12,310,96,7,1380,96,1,1284,1380
1.00E+12,511,4002,53.5,7480,16006,4,13914,29920
1.00E+12,200,314,12.6,2500,314,1,2186,2500
2.10E+12,310,521,11.6,4480,521,1,3959,4480
1.00E+12,310,795,16.3,4880,795,1,4085,4880
2.10E+12,100,827,11.6,7100,827,1,6273,7100
1.00E+12,100,3040,19,16000,3040,1,12960,16000
1.00E+12,100,504,14.5,3480,504,1,2976,3480
1.00E+12,500,3040,19,16000,3040,1,12960,16000
1.00E+12,310,159,7,2280,1908,12,25452,27360
1.00E+12,310,110,7,1580,110,1,1470,1580
1.00E+12,300,1500,20.1,7480,4500,3,17940,22440
1.00E+12,310,1054,7.5,13980,1054,1,12926,13980
1.00E+12,310,224,7.5,2980,224,1,2756,2980
1.00E+12,310,873,7.5,11580,873,1,10707,11580
1.00E+12,310,262,7.5,3480,262,1,3218,3480
2.10E+12,310,208,7,2980,208,1,2772,2980
2.10E+12,310,131,7,1880,131,1,1749,1880
2.10E+12,310,418,7,5980,836,2,11124,11960
2.10E+12,200,4495,32.3,13900,4495,1,9405,13900
1.00E+12,200,4250,17,25000,4250,1,20750,25000
1.00E+12,200,3400,17,20000,3400,1,16600,20000
2.10E+12,310,575,5,11500,575,1,10925,11500
1.00E+12,310,282,9.2,3080,282,1,2798,3080
7695649,310,90,9.1,990,90,1,900,990
1.00E+12,205,4170,30,13900,8340,2,19460,27800
1.00E+12,200,4800,15,32000,4800,1,27200,32000
1.00E+12,310,118,10,1180,118,1,1062,1180
7022396,310,548,10,5480,548,1,4932,5480
2.10E+12,200,1170,30,3900,2340,2,5460,7800
1.00E+12,340,105,7,1500,105,1,1395,1500
9077258,340,1434,53.5,2680,5734,4,4986,10720
2.10E+12,340,327,7,4680,327,1,4353,4680
7260002,310,313,8.7,3580,313,1,3267,3580
1.00E+12,310,349,5,6980,349,1,6631,6980
1.00E+12,310,64,5,1280,1600,25,30400,32000
6617649,240,1770,27.2,6500,1770,1,4730,6500
1.00E+12,100,1447,14.5,9980,1447,1,8533,9980
1.00E+12,310,198,10,1980,396,2,3564,3960
1.00E+12,310,1380,10,13800,8280,6,74520,82800
7151013,310,318,10,3180,318,1,2862,3180
1.00E+12,310,698,10,6980,1396,2,12564,13960
9595276,310,388,10,3880,776,2,6984,7760
1.00E+12,310,102,7.3,1400,204,2,2596,2800
1.00E+12,310,160,7.3,2200,160,1,2040,2200
7479645,310,313,7.3,4280,313,1,3967,4280
7252797,310,789,7.3,10800,789,1,10011,10800
1.00E+12,200,28802,21.5,134000,28802,1,105198,134000
10232951,205,654,30,2180,1308,2,3052,4360
1.00E+12,205,1194,30,3980,3582,3,8358,11940
1.00E+12,300,20970,11.7,180000,20970,1,159030,180000
1.00E+12,511,3040,40,7600,18240,6,27360,45600
1.00E+12,310,15948,25.6,62300,15948,1,46352,62300
2.10E+12,310,169,9,1880,169,1,1711,1880
1.00E+12,310,488,7,6980,976,2,12984,13960
1.00E+12,310,9280,14.5,64000,9280,1,54720,64000
1.00E+12,500,82500,5,1650000,82500,1,1567500,1650000
8914340,511,3626,52.5,6900,14503,4,13097,27600
1.00E+12,310,2961,5.1,58000,2961,1,55039,58000
1.00E+12,100,644,18.4,3500,644,1,2856,3500
6810933,100,2923,37,7900,5846,2,9954,15800
1.00E+12,100,1088,18.4,5900,6527,6,28873,35400
1.00E+12,100,1931,13.9,13900,3862,2,23938,27800
1.00E+12,100,2347,18.2,12900,2347,1,10553,12900
1.00E+12,310,133,7,1900,133,1,1767,1900
1.00E+12,310,152,7,2180,152,1,2028,2180
1.00E+12,310,138,7,1980,138,1,1842,1980
1.00E+12,310,495,10,4950,495,1,4455,4950
1.00E+12,240,1464,50.5,2900,24888,17,24412,49300
1.00E+12,240,13678,40.6,33700,41035,3,60065,101100
1.00E+12,100,39,1,3980,39,1,3941,3980
1.00E+12,100,1464,50.5,2900,24888,17,24412,49300
7643268,310,425,6.2,6810,425,1,6385,6810
1.00E+12,310,1061,9.8,10800,1061,1,9739,10800
1.00E+12,310,1276,9.8,12980,1276,1,11704,12980
1.00E+12,310,452,9.8,4600,452,1,4148,4600
1.00E+12,310,963,9.8,9800,963,1,8837,9800
9707916,310,273,9.8,2780,273,1,2507,2780
1.00E+12,310,538,9.8,5480,538,1,4942,5480
1.00E+12,310,1274,7,18200,2548,2,33852,36400
1.00E+12,310,178,9.5,1880,178,1,1702,1880
1.00E+12,310,4058,14,28970,4058,1,24912,28970
2.10E+12,310,2880,26.7,10800,2880,1,7920,10800
2.10E+12,200,2880,26.7,10800,2880,1,7920,10800
1.00E+12,200,3390,10,33900,3390,1,30510,33900
1.00E+12,310,593,5,11800,1185,2,22415,23600
1.00E+12,310,248,10,2480,248,1,2232,2480
8484691,340,267,5.8,4580,534,2,8626,9160
1.00E+12,310,418,7,5980,418,1,5562,5980
1.00E+12,310,208,7,2980,624,3,8316,8940
2.10E+12,310,418,7,5980,1254,3,16686,17940
1.00E+12,310,808,8.1,9980,808,1,9172,9980
8568431,310,346,8.1,4280,346,1,3934,4280
1.00E+12,310,128,8.1,1580,383,3,4357,4740
8491394,310,323,8.1,4000,323,1,3677,4000
1.00E+12,340,693,7,9900,693,1,9207,9900
1.00E+12,310,198,10,1980,792,4,7128,7920
1.00E+12,310,5040,28,18000,5040,1,12960,18000
1.00E+12,200,5040,28,18000,5040,1,12960,18000
1.00E+12,601,589,5.9,9900,589,1,9311,9900
6835821,100,19,1,1980,19,1,1961,1980
6621656,501,29,1,2900,29,1,2871,2900
1.00E+12,501,15,0.9,1580,75,5,7825,7900
1.00E+12,100,35,2,1780,35,1,1745,1780
1.00E+12,200,4100,9.3,43900,16400,4,159200,175600
6845378,100,178,10,1780,178,1,1602,1780
1.00E+12,200,1245,5,24900,1245,1,23655,24900
1.00E+12,310,762,16.3,4680,762,1,3918,4680
1.00E+12,310,1300,16.3,7980,1300,1,6680,7980
8308821,310,467,16.3,2870,467,1,2403,2870
1.00E+12,100,987,11.6,8480,987,1,7493,8480
1.00E+12,100,195,16.3,1200,390,2,2010,2400
7695348,100,301,16.3,1850,301,1,1549,1850
1.00E+12,100,734,24.6,2980,734,1,2246,2980
1.00E+12,240,2215,24.7,8980,2215,1,6765,8980
8334525,310,89,7,1280,445,5,5955,6400
1.00E+12,240,730,16.3,4480,1460,2,7500,8960
2.10E+12,100,790,10,7900,790,1,7110,7900
2.10E+12,310,110,7,1580,110,1,1470,1580
1.00E+12,310,460,7,6580,460,1,6120,6580
2.10E+12,200,1593,25.6,6225,7965,5,23160,31125
1.00E+12,200,4610,4.4,105600,4610,1,100990,105600
1.00E+12,310,343,7,4900,686,2,9114,9800
2.10E+12,240,2171,36.3,5980,6514,3,11426,17940
8283955,310,585,9,6500,585,1,5915,6500
2.10E+12,310,9143,22.4,40800,9143,1,31657,40800
2.10E+12,310,268,9,2980,268,1,2712,2980
1.00E+12,200,4680,12,39000,4680,1,34320,39000
1.00E+12,200,25020,20,125100,25020,1,100080,125100
1.00E+12,310,348,10,3480,348,1,3132,3480
1.00E+12,200,7110,15,47400,7110,1,40290,47400
1.00E+12,310,4071,54.4,7480,24426,6,20454,44880
6615248,100,203,8.8,2300,203,1,2097,2300
,,,,,,,,
9053152,310,1758,10,17580,1758,1,15822,17580
1.00E+12,310,1490,10.7,13900,1490,1,12410,13900
1.00E+12,200,7720,14,55200,7720,1,47480,55200
1.00E+12,200,7335,16.3,45000,7335,1,37665,45000
1.00E+12,200,1596,40.1,3980,3192,2,4768,7960
,,,,,,,,
1.00E+12,310,598,10,5980,598,1,5382,5980
2.10E+12,310,94,5,1880,376,4,7144,7520
8311805,310,119,5,2380,714,6,13566,14280
1.00E+12,200,8313,16.3,51000,8313,1,42687,51000
1.00E+12,310,159,7,2280,1908,12,25452,27360
1.00E+12,310,999,7,14280,999,1,13281,14280
1.00E+12,200,1144,11,10400,3432,3,27768,31200
1.00E+12,601,812,14.5,5600,812,1,4788,5600
1.00E+12,601,522,14.5,3600,1044,2,6156,7200
1.00E+12,310,230,10,2300,230,1,2070,2300
1.00E+12,300,220,4,5500,1100,5,26400,27500
6609563,310,187,7.9,2380,187,1,2193,2380
1.00E+12,310,330,10,3300,330,1,2970,3300
1.00E+12,310,698,10,6980,698,1,6282,6980
1.00E+12,200,1100,1.6,68000,1100,1,66900,68000
1.00E+12,310,268,10,2680,3216,12,28944,32160
2.10E+12,310,212,14.1,1500,212,1,1288,1500
2.10E+12,310,2246,27.7,8100,2246,1,5854,8100
1.00E+12,310,1450,9.7,14900,1450,1,13450,14900
1.00E+12,240,234,18.7,1250,701,3,3049,3750
1.00E+12,200,1396,20,6980,4188,3,16752,20940
1.00E+12,200,6669,17.6,38000,6669,1,31331,38000
1.00E+12,310,695,5,13900,1390,2,26410,27800
1.00E+12,310,99,5,1980,297,3,5643,5940
2.10E+12,310,648,32.7,1980,2592,4,5328,7920
,,,,,,,,
1.00E+12,310,3046,25.6,11900,3046,1,8854,11900
1.00E+12,310,131,7,1880,131,1,1749,1880
1.00E+12,310,558,7,7980,2232,4,29688,31920
2.10E+12,200,70500,54.7,129000,70500,1,58500,129000
2.10E+12,200,1000,18.2,5480,2000,2,8960,10960
6838606,310,184,5,3680,184,1,3496,3680
1.00E+12,310,329,9.4,3500,329,1,3171,3500
1.00E+12,310,139,9.4,1480,139,1,1341,1480
2.10E+12,310,270,10,2700,270,1,2430,2700
1.00E+12,310,178,7.2,2480,178,1,2302,2480
6615248,310,165,7.2,2300,330,2,4270,4600
1.00E+12,200,5768,14.5,39780,5768,1,34012,39780
1.00E+12,310,349,5,6980,698,2,13262,13960
1.00E+12,310,452,19,2380,904,2,3856,4760
1.00E+12,310,302,7,4320,2114,7,28126,30240
1.00E+12,310,990,10,9900,990,1,8910,9900
1.00E+12,205,13444,39.9,33700,26887,2,40513,67400
7150086,601,432,14.5,2980,432,1,2548,2980
1.00E+12,310,858,10,8580,858,1,7722,8580
1.00E+12,310,258,14.5,1780,516,2,3044,3560
1.00E+12,200,26656,28,95200,26656,1,68544,95200
8362410,310,336,7.9,4250,336,1,3914,4250
7549115,310,176,7.9,2230,176,1,2054,2230
7549115,501,176,7.9,2230,176,1,2054,2230
10698740,100,1000,11.8,8480,1000,1,7480,8480
1.00E+12,501,1059,11.8,8980,1059,1,7921,8980
10698740,501,1000,11.8,8480,1000,1,7480,8480
1.00E+12,500,5017,18.8,26730,5017,1,21713,26730
6617849,310,198,10,1980,396,2,3564,3960
1.00E+12,310,488,7,6980,488,1,6492,6980
8038420,310,203,7,2900,203,1,2697,2900
1.00E+12,310,750,10,7500,3750,5,33750,37500
1.00E+12,300,158,1,15800,158,1,15642,15800
7348242,200,4100,9.3,43900,16400,4,159200,175600
8333552,310,327,7,4680,654,2,8706,9360
3440345,200,1750,9.7,18020,7000,4,65080,72080
1.00E+12,200,14660,13,112830,14660,1,98170,112830
1.00E+12,310,400,10,4000,3600,9,32400,36000
1.00E+12,310,250,10,2500,250,1,2250,2500
8453055,310,510,10,5100,510,1,4590,5100
1.00E+12,310,398,10,3980,796,2,7164,7960
1.00E+12,310,2888,38,7600,8664,3,14136,22800
1.00E+12,310,698,10,6980,698,1,6282,6980
1.00E+12,240,851,19,4480,851,1,3629,4480
1.00E+12,310,851,19,4480,851,1,3629,4480
1.00E+12,240,1326,19,6980,1326,1,5654,6980
1.00E+12,310,1326,19,6980,1326,1,5654,6980
8076933,310,142,9.8,1450,284,2,2616,2900
2.10E+12,310,833,9.8,8480,833,1,7647,8480
1.00E+12,310,7026,23.5,29900,21078,3,68622,89700
1.00E+12,310,7026,23.5,29900,21078,3,68622,89700
1.00E+12,200,7026,23.5,29900,7026,1,22874,29900
7345041,310,488,10,4880,976,2,8784,9760
1.00E+12,310,272,9.1,2980,1632,6,16248,17880
2.10E+12,200,752,13.7,5500,4512,6,28488,33000
1.00E+12,200,1524,3,50800,1524,1,49276,50800
2.10E+12,310,74,5,1480,222,3,4218,4440
1.00E+12,240,400,4.9,8200,800,2,15600,16400
1.00E+12,100,2242,11.8,19000,2242,1,16758,19000
1.00E+12,100,3240,21.6,15000,3240,1,11760,15000
1.00E+12,310,1665,7.6,21900,1665,1,20235,21900
7604270,310,172,7,2470,172,1,2298,2470
7275221,310,278,7,3980,556,2,7404,7960
1.00E+12,300,4690,10,46900,4690,1,42210,46900
1.00E+12,310,6545,19.3,34000,6545,1,27455,34000
1.00E+12,310,750,5,15000,750,1,14250,15000
1.00E+12,240,7145,23.1,30900,28581,4,95019,123600
2.10E+12,310,1648,24.1,6850,1648,1,5202,6850
1.00E+12,200,7145,23.1,30900,28581,4,95019,123600
1.00E+12,500,70624,19.6,360000,70624,1,289376,360000
1.00E+12,310,222,9,2480,222,1,2258,2480
1.00E+12,310,2044,9,22800,2044,1,20756,22800
1.00E+12,340,1012,6.4,15900,1012,1,14888,15900
1.00E+12,300,1500,25.1,5980,3000,2,8960,11960
2.10E+12,310,698,10,6980,698,1,6282,6980
1.00E+12,310,790,9.9,7980,790,1,7190,7980
1.00E+12,310,1978,9.9,19980,1978,1,18002,19980
1.00E+12,310,1077,9.9,10880,1077,1,9803,10880
1.00E+12,310,1980,9.9,19980,1980,1,18000,19980
1.00E+12,200,5845,15,39000,5845,1,33155,39000
1.00E+12,240,444,17.9,2480,444,1,2036,2480
6618348,310,437,8.8,4950,873,2,9027,9900
1.00E+12,200,2369,11.6,20500,2369,1,18131,20500
1.00E+12,310,13651,40.2,34000,13651,1,20349,34000
8236054,310,51,7,730,510,10,6790,7300
1.00E+12,310,284,5,5680,568,2,10792,11360
1.00E+12,310,833,7,11900,833,1,11067,11900
1.00E+12,310,208,10,2080,415,2,3745,4160
10699515,310,734,10,7350,734,1,6616,7350
7456274,310,747,10,7480,747,1,6733,7480
1.00E+12,310,530,7,7580,530,1,7050,7580
1.00E+12,200,17076,17.5,97300,17076,1,80224,97300
1.00E+12,500,17076,17.5,97300,17076,1,80224,97300
2.10E+12,310,896,7,12800,896,1,11904,12800
1.00E+12,200,1525,9.8,15500,1525,1,13975,15500
1.00E+12,310,551,14.5,3800,551,1,3249,3800
1.00E+12,601,551,14.5,3800,551,1,3249,3800
1.00E+12,205,3300,30,11000,3300,1,7700,11000
1.00E+12,310,870,8,10900,870,1,10030,10900
1.00E+12,310,1486,9.5,15580,1486,1,14094,15580
1.00E+12,200,1717,7.8,21900,1717,1,20183,21900
1.00E+12,200,2880,15,19200,2880,1,16320,19200
8968177,310,929,6.6,13980,929,1,13051,13980
1.00E+12,310,1331,6.7,19980,2661,2,37299,39960
1.00E+12,310,530,6.6,7980,530,1,7450,7980
1.00E+12,200,2767,17.9,15500,2767,1,12733,15500
8241232,310,8704,22.4,38900,8704,1,30196,38900
6609430,310,194,8.6,2250,194,1,2056,2250
8241232,205,8704,22.4,38900,8704,1,30196,38900
1.00E+12,310,484,5,9680,484,1,9196,9680
9014178,100,420,10,4200,840,2,7560,8400
1.00E+12,310,238,10,2380,714,3,6426,7140
2.10E+12,310,780,10,7800,780,1,7020,7800
1.00E+12,310,838,7,11980,838,1,11142,11980
8049973,310,866,9.8,8800,866,1,7934,8800
1.00E+12,310,620,9.8,6300,1240,2,11360,12600
1.00E+12,310,318,10,3180,318,1,2862,3180
1.00E+12,310,197,9.9,1980,393,2,3567,3960
9749223,310,890,10,8900,890,1,8010,8900
7298644,310,668,10,6680,668,1,6012,6680
1.00E+12,340,1153,11.6,9900,1153,1,8747,9900
6615753,310,674,10,6740,4044,6,36396,40440
1.00E+12,200,1248,3,41600,1248,1,40352,41600
1.00E+12,310,3419,4.8,71920,3419,1,68501,71920
1.00E+12,310,1587,11.4,13900,1587,1,12313,13900
1.00E+12,310,516,11.8,4380,516,1,3864,4380
1.00E+12,200,1195,5,23900,1195,1,22705,23900
1.00E+12,310,2822,14.3,19800,5644,2,33956,39600
1.00E+12,200,541,14.2,3800,541,1,3259,3800
2.10E+12,200,1644,24,6850,3288,2,10412,13700
7350960,310,1448,36.7,3950,8688,6,15012,23700
1.00E+12,310,445,5,8900,445,1,8455,8900
8627003,310,228,10,2280,2736,12,24624,27360
1.00E+12,310,238,10,2380,238,1,2142,2380
8781553,100,848,10,8480,848,1,7632,8480
1.00E+12,310,210,5,4210,210,1,4000,4210
1.00E+12,310,117,7,1680,234,2,3126,3360
1.00E+12,205,5000,33.6,14900,20000,4,39600,59600
2.10E+12,310,279,3.5,7880,836,3,22804,23640
2.10E+12,310,138,3.5,3900,138,1,3762,3900
1.00E+12,300,15090,21.9,69000,15090,1,53910,69000
1.00E+12,200,4205,14.5,29000,4205,1,24795,29000
1.00E+12,500,19559,15.6,125300,19559,1,105741,125300
10226796,310,344,9.6,3580,687,2,6473,7160
1.00E+12,205,1099,11,9980,1099,1,8881,9980
1.00E+12,310,4045,14.5,27900,8090,2,47710,55800
1.00E+12,310,551,11.8,4680,551,1,4129,4680
1.00E+12,100,1274,11.8,10800,1274,1,9526,10800
1.00E+12,100,1011,11.8,8580,1011,1,7569,8580
6615248,100,271,11.8,2300,542,2,4058,4600
1.00E+12,310,263,9.5,2780,263,1,2517,2780
1.00E+12,310,377,9.5,3980,377,1,3603,3980
2.10E+12,310,1889,27.6,6850,1889,1,4961,6850
9067456,310,149,9.4,1580,149,1,1431,1580
1.00E+12,205,3531,18.6,18990,3531,1,15459,18990
2.10E+12,200,1717,27.6,6225,1717,1,4508,6225
8249673,310,438,10,4380,438,1,3942,4380
1.00E+12,310,218,10,2180,872,4,7848,8720
1.00E+12,310,390,10,3900,390,1,3510,3900
2.10E+12,200,925,37,2500,925,1,1575,2500
6609405,310,325,10,3250,975,3,8775,9750
1.00E+12,310,698,10,6980,698,1,6282,6980
1.00E+12,310,271,7,3880,1355,5,18045,19400
10051299,310,558,7,7980,2232,4,29688,31920
8277814,310,1112,40,2780,3336,3,5004,8340
8277814,511,1112,40,2780,3336,3,5004,8340
1.00E+12,310,193,9.7,1980,193,1,1787,1980
8228211,310,450,10,4500,450,1,4050,4500
1.00E+12,310,620,10,6200,620,1,5580,6200
6615198,310,148,10,1480,592,4,5328,5920
1.00E+12,340,110,0.6,19000,110,1,18890,19000
1.00E+12,300,24,1,2480,24,1,2456,2480
1.00E+12,310,598,10,5980,2392,4,21528,23920
1.00E+12,310,124,7,1780,1612,13,21528,23140
1.00E+12,100,1796,14.3,12600,1796,1,10804,12600
2.10E+12,205,2100,24.7,8500,2100,1,6400,8500
1.00E+12,310,186,7.8,2400,186,1,2214,2400
7607082,310,280,7.8,3600,280,1,3320,3600
1.00E+12,310,151,7.7,1950,151,1,1799,1950
1.00E+12,310,648,10,6480,2592,4,23328,25920
10356421,310,6251,19,32900,25004,4,106596,131600
1.00E+12,310,448,10,4480,448,1,4032,4480
1.00E+12,310,628,7,8980,628,1,8352,8980
1.00E+12,310,13051,20.9,62300,13051,1,49249,62300
1.00E+12,200,450,15,3000,450,1,2550,3000
1.00E+12,200,18730,19.2,97300,18730,1,78570,97300
1.00E+12,310,418,7,5980,836,2,11124,11960
1.00E+12,310,22804,23.2,98400,22804,1,75596,98400
1.00E+12,200,7200,15,48000,7200,1,40800,48000
1.00E+12,310,543,8.8,6180,543,1,5637,6180
1.00E+12,310,147,8.8,1680,147,1,1533,1680
6609728,310,396,8.8,4500,396,1,4104,4500
1.00E+12,200,2640,5,52800,2640,1,50160,52800
1.00E+12,310,216,2.4,8900,216,1,8684,8900
1.00E+12,310,60,2.4,2480,60,1,2420,2480
1.00E+12,310,57,2.4,2380,57,1,2323,2380
8104634,310,48,2.4,1980,48,1,1932,1980
7054085,310,72,2.4,2980,72,1,2908,2980
1.00E+12,310,48,2.4,1980,48,1,1932,1980
7264179,310,320,2.4,13180,320,1,12860,13180
7238924,310,48,2.4,1980,48,1,1932,1980
1.00E+12,310,194,2.4,7980,194,1,7786,7980
1.00E+12,310,48,2.4,1980,48,1,1932,1980
1.00E+12,310,52,2.4,2180,52,1,2128,2180
1.00E+12,511,2551,51.2,4980,5101,2,4859,9960
8363041,310,1270,8.9,14300,1270,1,13030,14300
7058780,310,598,10,5980,1196,2,10764,11960
1.00E+12,200,10350,15,69000,31050,3,175950,207000
1.00E+12,310,274,5,5480,274,1,5206,5480
1.00E+12,310,899,9.2,9800,899,1,8901,9800
1.00E+12,200,7420,15,49500,7420,1,42080,49500
10626397,310,2781,14,19800,5562,2,34038,39600
1.00E+12,310,348,7,4980,348,1,4632,4980
1.00E+12,310,376,7,5380,752,2,10008,10760
1.00E+12,310,277,7,3960,277,1,3683,3960
1.00E+12,310,613,20.6,2980,1225,2,4735,5960
2.10E+12,310,255,6.5,3900,255,1,3645,3900
7021920,310,64,6.5,980,128,2,1832,1960
1.00E+12,511,226,22.1,1020,1354,6,4766,6120
2.10E+12,200,4648,33.4,13900,4648,1,9252,13900
2.10E+12,200,2044,25.2,8100,2044,1,6056,8100
2.10E+12,205,1206,25.2,4780,2412,2,7148,9560
1.00E+12,200,1850,8.9,20900,1850,1,19050,20900
2.10E+12,200,1495,20,7475,8970,6,35880,44850
1.00E+12,310,149,5,2980,745,5,14155,14900
1.00E+12,310,593,7,8480,1186,2,15774,16960
1.00E+12,310,903,7,12900,903,1,11997,12900
7050044,340,208,7,2980,208,1,2772,2980
7882690,310,391,9.8,3980,391,1,3589,3980
1.00E+12,310,273,6.9,3980,273,1,3707,3980
,,,,,,,,
,,,,,,,,
1.00E+12,200,1120,5,22400,2240,2,42560,44800
1.00E+12,200,1165,11.7,10000,3495,3,26505,30000
8097965,310,324,5,6480,648,2,12312,12960
1.00E+12,310,299,5,5980,897,3,17043,17940
8228240,310,2436,55,4430,4872,2,3988,8860
8228240,511,2436,55,4430,4872,2,3988,8860
1.00E+12,310,324,5,6480,324,1,6156,6480
1.00E+12,310,7168,25.6,28000,7168,1,20832,28000
1.00E+12,310,280,9.7,2880,280,1,2600,2880
7531958,310,124,5,2480,248,2,4712,4960
1.00E+12,310,860,5,17200,1720,2,32680,34400
1.00E+12,310,333,9,3680,666,2,6694,7360
2.10E+12,310,593,27.2,2180,1186,2,3174,4360
2.10E+12,310,159,5,3180,318,2,6042,6360
1.00E+12,310,274,6.9,3980,274,1,3706,3980
